薙	艹矢亻亠龶
菈	艹扌立
诶	讠厶矢
欸	厶矢⺈人
哟	口纟勺
唷	口亠厶月
啊	口阝丁口
阿	阝丁口
吖	口丫
锕	钅阝丁口
腌	月大电
爱	丿⺍冖𠂇又
艾	艹乂
哎	口艹乂
唉	口厶矢
哀	亠口𧘇
挨	扌厶矢
埃	土厶矢
矮	矢禾女
碍	石日一寸
暧	日丿⺍冖𠂇又
癌	疒口口口山
蔼	艹讠日勹人乛
隘	阝丷一八皿
皑	白山己
霭	雨讠日勹人乛
嗳	口丿⺍冖𠂇又
嫒	女丿⺍冖𠂇又
毐	士毋
叆	二厶丿⺍冖𠂇又
瑷	王丿⺍冖𠂇又
砹	石艹乂
锿	钅亠口𧘇
嗌	口丷一八皿
按	扌宀女
安	宀女
暗	日立日
案	宀女木
岸	山厂干
俺	亻大电
黯	黑立日
庵	广大电
鞍	革宀女
谙	讠立日
氨	气宀女
胺	月宀女
鹌	大电鸟
桉	木宀女
犴	犭干
唵	口大电
铵	钅宀女
埯	土大电
盦	人丶乛酉皿
垵	土宀女
𩽾	鱼宀女
昂	日丿乛卩
肮	月亠几
盎	央皿
卬	丿乛卩
傲	亻龶乛丿攵
奥	丿冂米大
熬	龶乛丿攵灬
敖	龶乛丿攵
澳	氵丿冂米大
凹	丨乛丨乛一
懊	忄丿冂米大
嗷	口龶乛丿攵
拗	扌幺力
袄	衤夭
鳌	龶乛丿攵鱼
翱	白大十习习
獒	龶乛丿攵犬
骜	龶乛丿攵马
坳	土幺力
鏖	广乛丨丨一比左匕金
遨	辶龶乛丿攵
媪	女日皿
螯	龶乛丿攵虫
岙	夭山
璈	王龶乛丿攵
鏊	龶乛丿攵金
聱	龶乛丿攵耳
廒	广龶乛丿攵
奡	一自大丿丨
隩	阝丿冂米大
薁	艹丿冂米大
嶅	龶乛丿攵山
把	扌巴
吧	口巴
八	丿ㄟ
爸	八乂巴
巴	巳丨
罢	罒土厶
拔	扌𠂇又丶
霸	雨革月
疤	疒巴
跋	⻊𠂇又丶
扒	扌八
叭	口八
芭	艹巴
靶	革巴
坝	土冂人
耙	耒巴
笆	⺮巴
魃	鬼𠂇又丶
粑	米巴
钯	钅巴
灞	氵雨革月
捌	扌口力刂
鲅	鱼𠂇又丶
岜	山巴
鲃	鱼巴
菝	艹扌𠂇又丶
蚆	虫巴
胈	月𠂇又丶
羓	⺶巴
朳	木八
妭	女𠂇又丶
白	丿日
百	一白
败	冂人攵
摆	扌罒土厶
拜	龵一丰
柏	木白
掰	龵八刀手
伯	亻白
佰	亻百
稗	禾丿丨乛一一丿十
捭	扌丿丨乛一一丿十
半	丶丿一一丨
办	力丿丶
般	舟几又
板	木丿丿又
班	王丶丿王
伴	亻半
版	片丿丿又
搬	扌舟几又
扮	扌八刀
斑	王文王
扳	扌丿丿又
瓣	立𠂇瓜立十
绊	纟半
颁	八刀一丿冂人
拌	扌半
阪	阝丿丿又
坂	土丿丿又
瘢	疒舟几又
钣	钅丿丿又
癍	疒王文王
攽	八刀攵
柈	木半
昄	日丿丿又
湴	氵丷亚
靽	革半
𨭉	文一弋止金
帮	寿上阝巾
膀	月亠丷冖方
邦	寿上阝
棒	木寿上ㄟ一一丨
绑	纟寿上阝
榜	木亠丷冖方
傍	亻亠丷冖方
磅	石亠丷冖方
梆	木寿上阝
镑	钅亠丷冖方
谤	讠亠丷冖方
蚌	虫丰
浜	氵丘八
蒡	艹亠丷冖方
玤	王丰
搒	扌亠丷冖方
塝	土亠丷冖方
𠳐	口寿上阝
保	亻口木
报	扌卩又
包	勹巳
宝	宀玉
抱	扌勹巳
暴	日艹一八氺
爆	火日艹一八氺
薄	艹氵甫寸
堡	亻口木土
饱	饣勹巳
豹	豸勺
胞	月勹巳
剥	彐氺刂
鲍	鱼勹巳
褒	亠亻口木𧘇
刨	勹巳刂
苞	艹勹巳
鸨	匕十鸟
曝	日日艹一八氺
煲	亻口木火
葆	艹亻口木
雹	雨勹巳
褓	衤亻口木
炮	火勹巳
龅	止人凵勹巳
孢	子勹巳
趵	⻊勺
枹	木勹巳
瀑	氵日艹一八氺
被	衤乛丿丨又
备	夂田
北	丨一一匕
背	丨一一匕月
呗	口冂人
杯	木不
辈	非车
悲	非心
贝	冂人
倍	亻立口
卑	丿丨乛一一丿十
惫	夂田心
碑	石丿丨乛一一丿十
狈	犭冂人
蓓	艹亻立口
悖	忄十冖子
孛	十冖子
焙	火立口
邶	丨一一匕阝
陂	阝乛丿丨又
钡	钅冂人
褙	衤丨一一匕月
碚	石立口
鞴	革艹一丿用
鐾	尸口立十金
鹎	丿丨乛一一丿十鸟
棓	木立口
糒	米艹一丿用
琲	王非
椑	木丿丨乛一一丿十
臂	尸口立十月
鞁	革乛丿丨又
𬇙	氵冂人
本	一丨丿ㄟ一
奔	大十廾
笨	⺮本
贲	十艹冂人
苯	艹本
锛	钅大十廾
畚	厶大田
犇	牛牛牛
坌	八刀土
倴	亻大十廾
栟	木丷开
崩	山月月
蹦	⻊山月月
绷	纟月月
迸	辶丷开
甭	不用
嘣	口山月月
泵	石水
镚	钅山月月
甏	士口丷一丿丿丿瓦
琫	王寿上ㄟ一一丨
祊	礻方
比	比左匕
必	丶乛丶丿丶
毕	比左匕十
笔	⺮毛
避	辶尸口立十
闭	门才
鼻	自田一丿丨
逼	辶一口田
屄	尸宀八
壁	尸口立十土
彼	彳乛丿丨又
碧	王白石
币	丿巾
陛	阝比左匕土
鄙	口十囗口阝
蔽	艹丶丿丨乛丨丿丶攵
匕	丿乛
毙	比左匕歹匕
辟	尸口立十
婢	女丿丨乛一一丿十
弊	丶丿丨乛丨丿丶攵廾
璧	尸口立十玉
庇	广比左匕
敝	丶丿丨乛丨丿丶攵
痹	疒田一丿丨
弼	弓百弓
俾	亻丿丨乛一一丿十
裨	衤丿丨乛一一丿十
薜	艹尸口立十
哔	口比左匕十
愎	忄丿一日夂
吡	口比左匕
跸	⻊比左匕十
妣	女比左匕
篦	⺮丿囗乂比左匕
荜	艹比左匕十
狴	犭比左匕土
毖	比左匕必
蓖	艹丿囗乂比左匕
嬖	尸口立十女
筚	⺮比左匕十
髀	骨丿丨乛一一丿十
荸	艹十冖子
濞	氵自田一丿丨
畀	田一丿丨
赑	冂人冂人冂人
秕	禾比左匕
箅	⺮田一丿丨
芘	艹比左匕
佛	亻弗
襞	尸口立十亠𧘇
苾	艹必
滗	氵⺮毛
铋	钅必
庳	广丿丨乛一一丿十
萆	艹丿丨乛一一丿十
皕	百百
咇	口必
舭	舟比左匕
沘	氵比左匕
珌	王必
觱	戌口⺈用
诐	讠乛丿丨又
邲	必阝
佖	亻必
馝	禾日必
坒	比左匕土
泌	氵必
秘	禾必
鲾	鱼一口田
边	辶力
便	亻更
变	亠丨丨丿丶又
遍	辶户冂艹
编	纟户冂艹
辩	立𠂇讠立十
鞭	革亻更
辨	立𠂇丶丿立十
扁	户冂艹
辫	立𠂇纟立十
贬	冂人乏
蝙	虫户冂艹
匾	匚户冂艹
卞	丶下
汴	氵卞
弁	厶廾
砭	石乏
煸	火户冂艹
褊	衤户冂艹
笾	⺮力辶
鳊	鱼户冂艹
昪	日厶廾
忭	忄卞
苄	艹卞
抃	扌卞
碥	石户冂艹
萹	艹户冂艹
𨚕	厶廾阝
表	龶𧘇
标	木二小
镖	钅西二小
彪	虍几丿丿丿
飙	犬犬犬几乂
婊	女龶𧘇
骠	马西二小
镳	钅广乛丨丨一比左匕灬
膘	月西二小
裱	衤龶𧘇
杓	木勺
飑	几乂勹巳
俵	亻龶𧘇
鳔	鱼西二小
摽	扌西二小
瘭	疒西二小
熛	火西二小
藨	艹广乛丨丨一比左匕灬
儦	亻广乛丨丨一比左匕灬
骉	马马马
瀌	氵广乛丨丨一比左匕灬
幖	巾西二小
脿	月龶𧘇
别	口力刂
憋	丶丿丨乛丨丿丶攵心
瘪	疒自人匕
鳖	丶丿丨乛丨丿丶攵鱼
蹩	丶丿丨乛丨丿丶攵口丨一人
癿	白乛
宾	宀丘八
彬	木木丿丿丿
斌	文一弋止
滨	氵宀丘八
鬓	一丨一二厶丿丿丿宀丘八
缤	纟宀丘八
镔	钅宀丘八
濒	氵止丨丿丿一丿冂人
槟	木宀丘八
殡	歹宀丘八
膑	月宀丘八
摈	扌宀丘八
玢	王八刀
傧	亻宀丘八
豳	山豕豕
邠	八刀阝
髌	骨宀丘八
并	丷开
兵	丘八
冰	冫水
病	疒丙
柄	木丙
饼	饣丷开
禀	亠囗口二小
秉	丿一乛一一丨丿ㄟ
丙	一内
炳	火丙
摒	扌尸丷开
屏	尸丷开
邴	丙阝
昺	日丙
蛃	虫丙
波	氵乛丿丨又
博	十甫寸
脖	月十冖子
拨	扌乛丿又丶
播	扌丿米田
勃	十冖子力
玻	王乛丿丨又
膊	月甫寸
搏	扌甫寸
驳	马乂乂
泊	氵白
簸	⺮其上八乛丿丨又
帛	白巾
钵	钅本
跛	⻊乛丿丨又
渤	氵十冖子力
菠	艹氵乛丿丨又
礴	石艹氵甫寸
啵	口氵乛丿丨又
舶	舟白
卜	丨丶
饽	饣十冖子
铂	钅白
钹	钅𠂇又丶
箔	⺮氵白
亳	亠口冖丿七
擘	尸口立十手
檗	尸口立十木
鹁	十冖子鸟
僰	一丨乛丨丿ㄟ一丨乛丨丿ㄟ人
踣	⻊立口
镈	钅甫寸
砵	石本
鲌	鱼白
哱	口十冖子
嶓	山丿米田
浡	氵十冖子
馞	禾日十冖子
艴	弗⺈巴
蕃	艹丿米田
欂	木艹氵甫寸
袯	衤乛丿又丶
𬭛	钅氵乛丿丨又
不	一丿丨丶
部	立口阝
步	止丨丿丿
布	𠂇巾
补	衤卜
怖	忄𠂇巾
捕	扌甫
簿	⺮氵甫寸
埔	土甫
哺	口甫
埠	土丿㠯十
卟	口卜
逋	辶甫
钚	钅不
晡	日甫
瓿	立口瓦
醭	酉业⺶ㄟ
蔀	艹立口阝
埗	土止丨丿丿
𬷕	甫鸟
擦	扌宀丿乛丶丶二小
嚓	口宀丿乛丶丶二小
才	一丨丿
菜	艹丿⺍木
彩	丿⺍木丿丿丿
采	丿⺍木
财	冂人才
材	木才
猜	犭龶月
蔡	艹丿乛丶丶二小
裁	十戈亠𧘇
踩	⻊丿⺍木
睬	目丿⺍木
偲	亻田心
参	厶大丿丿丿
残	歹戋
惨	忄厶大丿丿丿
餐	丨一夕又人良
灿	火山
惭	忄车斤
蚕	天虫
璨	王丨一夕又米
粲	丨一夕又米
骖	马厶大丿丿丿
黪	黑厶大丿丿丿
䅟	禾厶大丿丿丿
藏	艹戊乛一丿臣
苍	艹人乛乛
仓	人乛乛
舱	舟人乛乛
沧	氵人乛乛
伧	亻人乛乛
鸧	人乛乛鸟
草	艹日十
操	扌口口口木
肏	入内人
曹	一丨乛一丨丨一日
嘈	口一丨乛一丨丨一日
糙	米⺧口辶
槽	木一丨乛一丨丨一日
漕	氵一丨乛一丨丨一日
艚	舟一丨乛一丨丨一日
螬	虫一丨乛一丨丨一日
𥕢	石一丨乛一丨丨一日
策	⺮一丨乛丨丿ㄟ
侧	亻冂人刂
测	氵冂人刂
册	丿乛丿乛一
厕	厂冂人刂
恻	忄冂人刂
岑	山人丶乛
涔	氵山人丶乛
曾	丷囗⺌日
层	尸二厶
蹭	⻊丷囗⺌日
噌	口丷囗⺌日
嶒	山丷囗⺌日
差	⺶工
查	木日一
察	宀丿乛丶丶二小
茶	艹人朩
插	扌千臼
诧	讠宀丿七
叉	又丶
岔	八刀山
茬	艹𠂇丨土
衩	衤叉
碴	石木日一
姹	女宀丿七
杈	木叉
搽	扌艹人朩
刹	乂朩刂
檫	木宀丿乛丶丶二小
槎	木⺶工
汊	氵叉
镲	钅宀丿乛丶丶二小
锸	钅千臼
馇	饣木日一
垞	土宀丿七
侘	亻宀丿七
猹	犭木日一
蹅	⻊木日一
嵖	山木日一
喳	口木日一
𥻗	米木日一
拆	扌斥
柴	止匕木
钗	钅叉
豺	豸才
侪	亻文丿丨
茝	艹匚丨口丨
虿	万虫
瘥	疒⺶工
产	立丿
颤	亠囗口日一一丿冂人
缠	纟广里
禅	礻丷丨乛一一一丨
蝉	虫丷丨乛一一一丨
搀	扌⺈丨乛一丿乛丶丶
铲	钅产
婵	女丷丨乛一一一丨
掺	扌厶大丿丿丿
阐	门丷丨乛一一一丨
忏	忄千
馋	饣⺈丨乛一丿乛丶丶
潺	氵尸子子子
蟾	虫⺈厂八亠一一口
谄	讠⺈臼
谗	讠⺈丨乛一丿乛丶丶
孱	尸子子子
冁	丷丨乛一一一丨尸艹一乛丿ㄟ
澶	氵亠囗口日一
觇	丨一口冂见下
镡	钅西日十
羼	尸羊⺶羊
廛	广里八土
巉	山⺈口比左匕⺈丨乛一丿乛丶
蒇	艹戊冂人
韂	革⺈厂八亠一一口
躔	⻊广里八土
刬	戋刂
浐	氵产
襜	衤⺈厂八亠一一口
瀍	氵广里八土
骣	马尸子子子
镵	钅⺈口比左匕⺈丨乛一丿乛丶
旵	日山
啴	口丷丨乛一一一丨
梴	木丿丨一乛廴
儳	亻⺈口比左匕⺈丨乛一丿乛丶
单	丷丨乛一一一丨
辿	辶山
𬊤	火丷丨乛一一一丨
长	丿一乛ㄟ
常	⺌冖口巾
场	土乛丿丿
唱	口日日
厂	一丿
尝	⺌冖二厶
昌	日日
畅	申乛丿丿
肠	月乛丿丿
偿	亻⺌冖二厶
敞	⺌冂口攵
怅	忄长
倡	亻日日
娼	女日日
嫦	女⺌冖口巾
猖	犭日日
昶	永日
徜	彳⺌冂口
氅	⺌冂口攵毛
伥	亻长
裳	⺌冖口亠𧘇
菖	艹日日
苌	艹长
阊	门日日
鬯	乂丶丶丶丶凵匕
惝	忄⺌冂口
鲳	鱼日日
鲿	鱼⺌冖二厶
𬬮	钅长
朝	十日十月
超	土丨一人刀口
潮	氵十日十月
吵	口少
嘲	口十日十月
抄	扌少
炒	火少
巢	乛乛乛果
钞	钅少
晁	日儿冫丿丶
焯	火丨一日十
耖	耒少
怊	忄刀口
弨	弓刀口
绰	纟丨一日十
车	一乛一丨
彻	彳七刀
扯	扌止
撤	扌亠厶月攵
澈	氵亠厶月攵
掣	丿一一丨乛丨刂手
砗	石车
坼	土斥
尺	尸ㄟ
㬚	日亠厶月攵
沉	氵冖几
陈	阝东
臣	匚丨乛一丨
晨	日厂二乛丿ㄟ
尘	小土
趁	土丨一人人丿丿丿
辰	厂二乛丿ㄟ
衬	衤寸
嗔	口十具上八
琛	王冖八木
称	禾⺈小
宸	宀厂二乛丿ㄟ
忱	忄丶乛丿乛
抻	扌申
碜	石厶大丿丿丿
谌	讠其上八乛
谶	讠人人戈韭
郴	木木阝
棽	木木人丶乛
瞋	目十具上八
榇	木立朩
龀	止人凵匕
疢	疒火
梣	木山人丶乛
煁	火其上八乛
𬘭	纟木木
成	戊乛
城	土成
程	禾口王
承	乛丨一一一乛丿ㄟ
诚	讠成
盛	成皿
乘	千丨一一匕丿ㄟ
撑	扌⺌冖口手
呈	口王
惩	彳正心
丞	了乛丿ㄟ一
澄	氵乛丶丿丿ㄟ一口丷一
逞	辶口王
橙	木乛丶丿丿ㄟ一口丷一
骋	马由一乛
瞠	目⺌冖口土
秤	禾平
铖	钅成
塍	月龹土
琤	王⺈乛一一丨
裎	衤口王
澂	氵山一王攵
埕	土口王
柽	木又土
蛏	虫又土
酲	酉口王
枨	木长
珵	王口王
赪	土丿丨丿丶丨一冂人
偁	亻丿⺍冉
宬	宀成
牚	⺌冂口牙
珹	王成
憕	忄乛丶丿丿ㄟ一口丷一
庱	广土八夂
晟	日成
铛	钅⺌彐
吃	口乞
持	扌土寸
迟	辶尺
赤	土丿丨丿丶
痴	疒矢口
池	氵也
齿	止人凵
斥	丿丿一丨丶
驰	马也
耻	耳止
翅	十又习习
哧	口土丿丨丿丶
炽	火口八
嗤	口乛丨丨一虫
蚩	乛丨丨一虫
叱	口匕
弛	弓也
侈	亻夕夕
啻	亠丷冖巾口
敕	束攵
螭	虫亠乂凵丨乛乛丶
魑	鬼亠乂凵丨乛乛丶
饬	饣丿一力
笞	⺮厶口
匙	日一丨一人匕
踟	⻊矢口
墀	土尸氺牛
豉	一口丷一十又
媸	女乛丨丨一虫
褫	衤丿丿虍几
鸱	氐鸟
彳	丿亻
茌	艹亻士
篪	⺮丿丿虍几
瘛	疒丰刀心
摛	扌亠乂凵丨乛乛丶
眵	目夕夕
傺	亻丿乛丶丶二小
漦	未攵厂水
胣	月丿一也
瓻	乂𠂇巾瓦
痓	疒一厶土
𫄨	纟乂𠂇巾
冲	冫中
充	亠厶儿
重	丿一丨乛一一丨一一
虫	中一丶
崇	山宀二小
宠	宀龙
忡	忄中
憧	忄立里
铳	钅亠厶儿
舂	寿上ㄟ臼
艟	舟立里
翀	习习中
茺	艹亠厶儿
珫	王亠厶儿
漴	氵山宀二小
涌	氵龴用
种	禾中
㳘	氵亠厶儿
摏	扌寿上ㄟ臼
抽	扌由
仇	亻九
臭	自犬
丑	乛丨一一
愁	禾火心
筹	⺮寿上寸
瞅	目禾火
酬	酉州
绸	纟冂土口
畴	田寿上寸
踌	⻊寿上寸
惆	忄冂土口
稠	禾冂土口
俦	亻寿上寸
雠	亻亠龶讠亻亠龶
瘳	疒习习人丿丿丿
犨	亻亠龶亻亠龶牛
帱	巾寿上寸
杻	木丑
侴	人一丑刂
椆	木冂土口
出	乛丨丨凵
处	夂卜
楚	木木乛丨一人
除	阝人余下
初	衤刀
触	⺈用虫
厨	厂一口丷一寸
础	石出
储	亻讠耂日
畜	亠幺田
褚	衤耂日
搐	扌亠幺田
橱	木厂一口丷一寸
躇	⻊艹耂日
雏	⺈彐亻亠龶
锄	钅且力
矗	十具上十具上十具上
杵	木午
楮	木耂日
怵	忄术
黜	黑出
绌	纟出
蜍	虫人余下
刍	⺈彐
滁	氵阝人余下
樗	木雨亏
蹰	⻊厂一口丷一寸
憷	忄木木乛丨一人
亍	二丨
俶	亻上小又
斶	斤罒勹虫
摴	扌雨亏
䝙	豸匚乂
䢺	出阝
濋	氵木木乛丨一人
琡	王上小又
𬺓	止人凵木木乛丨一人
欻	火火⺈人
揣	扌山而
踹	⻊山而
搋	扌丿丿虍几
啜	口又又又又
传	亻专
穿	宀八牙
船	舟几口
川	丿丨丨
喘	口山而
串	丨乛一丨乛一丨
钏	钅川
椽	木乛乛豕
舛	夕一乛丨
遄	辶山而
氚	气川
床	广木
窗	宀八丿囗夂
创	人乛乛刂
疮	疒人乛乛
闯	门马
怆	忄人乛乛
幢	巾立里
噇	口立里
吹	口⺈人
垂	丿一丨一丨丨一一
锤	钅垂
捶	扌垂
炊	火⺈人
槌	木丿㠯辶
陲	阝垂
棰	木垂
倕	亻垂
圌	囗山而
春	寿上ㄟ日
纯	纟屯
唇	厂二乛丿ㄟ口
蠢	寿上ㄟ日虫虫
淳	氵亠口子
醇	酉亠口子
椿	木寿上ㄟ日
鹑	亠口子鸟
莼	艹纟屯
蝽	虫寿上ㄟ日
瑃	王寿上ㄟ日
䲠	鱼寿上ㄟ日
堾	土寿上ㄟ日
𬭚	钅亠口子
戳	习习亻亠龶戈
龊	止人凵口丨一人
辍	车又又又又
踔	⻊丨一日十
惙	忄又又又又
逴	辶丨一日十
此	止匕
次	冫⺈人
刺	一丨乛丨丿ㄟ刂
词	讠乛一口
辞	千口立十
慈	丷一幺幺心
赐	冂人日勿
磁	石丷一幺幺
伺	亻乛一口
瓷	冫⺈人瓦
茨	艹冫⺈人
雌	止匕亻亠龶
祠	礻乛一口
呲	口止匕
疵	疒止匕
泚	氵止匕
糍	米丷一幺幺
鹚	丷一幺幺鸟
茈	艹止匕
跐	⻊止匕
玼	王止匕
佽	亻冫⺈人
兹	丷一幺幺
莿	艹一丨乛丨丿ㄟ刂
𫚖	止匕鱼
从	人人
匆	勹丿丿丶
聪	耳丷口心
丛	人人一
葱	艹匆心
琮	王宀二小
淙	氵宀二小
囱	丿囗夂
骢	马丿囗夂心
苁	艹人人
枞	木人人
璁	王丿囗夂心
熜	火丿囗夂心
悰	忄宀二小
凑	冫寿上ㄟ天
辏	车寿上ㄟ天
腠	月寿上ㄟ天
粗	米且
促	亻口丨一人
醋	酉艹一日
簇	⺮方丿一矢
猝	犭亠人人十
蹙	戊上小口丨一人
蹴	⻊亠口小尤
卒	亠人人十
徂	彳且
殂	歹且
蔟	艹方丿一矢
窜	宀八串
蹿	⻊宀八串
篡	⺮目大厶
撺	扌宀八串
攒	扌⺧儿⺧儿冂人
汆	入水
爨	丿丨一一冂一口乛一一冖木木大火
镩	钅宀八串
脆	月⺈厂乛乛
催	亻山亻亠龶
翠	习习亠人人十
崔	山亻亠龶
摧	扌山亻亠龶
粹	米亠人人十
悴	忄亠人人十
璀	王山亻亠龶
啐	口亠人人十
萃	艹亠人人十
瘁	疒亠人人十
淬	氵亠人人十
榱	木亠丨乛一一𧘇
毳	毛毛毛
漼	氵山亻亠龶
缞	纟亠丨乛一一𧘇
存	𠂇丨子
村	木寸
寸	一丨丶
忖	忄寸
皴	厶八夂乛丿丨又
邨	屯阝
错	钅艹一日
措	扌艹一日
挫	扌人人土
搓	扌⺶工
撮	扌日耳又
磋	石⺶工
蹉	⻊⺶工
锉	钅人人土
厝	厂艹一日
矬	矢人人土
嵯	山⺶工
痤	疒人人土
鹾	丨一囗乂⺶工
脞	月人人土
瑳	王⺶工
棤	木艹一日
莝	艹人人土
大	𠂇ㄟ
打	扌丁
答	⺮人一口
达	辶大
搭	扌艹人一口
哒	口大辶
瘩	疒艹人一口
嗒	口艹人一口
沓	水日
耷	大耳
鞑	革大辶
靼	革日一
妲	女日一
褡	衤艹人一口
跶	⻊大辶
怛	忄日一
笪	⺮日一
垯	土大辶
溚	氵艹人一口
炟	火日一
荙	艹大辶
鿎	石大辶
𨱏	钅艹人一口
𫟼	钅大辶
带	带上冖巾
代	亻弋
待	彳土寸
呆	口木
袋	亻弋亠𧘇
戴	十戈田艹一八
黛	亻弋黑
歹	一夕
贷	亻弋冂人
逮	辶乛一一丨冫丿ㄟ
怠	厶口心
殆	歹厶口
岱	亻弋山
玳	王亻弋
呔	口太
傣	亻寿上ㄟ氺
迨	辶厶口
绐	纟厶口
叇	二厶乛一一丨冫丿ㄟ辶
埭	土乛一一丨冫丿ㄟ
骀	马厶口
轪	车大
垈	亻弋土
但	亻日一
淡	氵火火
担	扌日一
弹	弓丷丨乛一一一丨
丹	丿乛丶一
蛋	乛丨一人虫
胆	月日一
旦	日一
诞	讠丿丨一乛廴
耽	耳丶乛丿乛
惮	忄丷丨乛一一一丨
石	一丿口
眈	目丶乛丿乛
澹	氵⺈厂八亠一一口
掸	扌丷丨乛一一一丨
郸	丷丨乛一一一丨阝
殚	歹丷丨乛一一一丨
啖	口火火
氮	气火火
儋	亻⺈厂八亠一一口
聃	耳冉
箪	⺮丷丨乛一一一丨
亶	亠囗口日一
疸	疒日一
萏	艹⺈臼
瘅	疒丷丨乛一一一丨
疍	乛丨一人日一
赕	冂人火火
憺	忄⺈厂八亠一一口
膻	月亠囗口日一
𫢸	亻丷丨乛一一一丨
𬘘	纟丶乛丿乛
当	⺌彐
党	⺌冖口儿
荡	艹氵乛丿丿
挡	扌⺌彐
档	木⺌彐
裆	衤⺌彐
宕	宀石
砀	石乛丿丿
珰	王⺌彐
凼	水凵
谠	讠⺌冖口儿
垱	土⺌彐
菪	艹宀石
筜	⺮⺌彐
𣗋	木⺌冖口儿
𬍡	氵乛丿丿玉
到	一厶土刂
倒	亻一厶土刂
道	辶丷一自
刀	乛丿
导	巳寸
岛	丿乛丶乛山
盗	冫⺈人皿
叨	口刀
蹈	⻊丿⺍臼
祷	礻寿上寸
捣	扌丿乛丶乛山
稻	禾丿⺍臼
悼	忄丨一日十
纛	龶母具上小丿幺小
忉	忄刀
氘	气丿丨
捯	扌一厶土刂
鱽	鱼刀
舠	舟刀
的	白勺
地	土也
得	彳日一寸
德	彳十罒一心
嘚	口彳日一寸
锝	钅日一寸
扽	扌屯
等	⺮土寸
灯	火丁
登	乛丶丿丿ㄟ一口丷一
瞪	目乛丶丿丿ㄟ一口丷一
邓	又阝
凳	乛丶丿丿ㄟ一口丷一几
蹬	⻊乛丶丿丿ㄟ一口丷一
噔	口乛丶丿丿ㄟ一口丷一
镫	钅乛丶丿丿ㄟ一口丷一
磴	石乛丶丿丿ㄟ一口丷一
戥	日生戈
嶝	山乛丶丿丿ㄟ一口丷一
璒	王乛丶丿丿ㄟ一口丷一
第	⺮乛一乛丨丿
弟	丷乛一乛丨丿
底	广氐
低	亻氐
帝	亠丷冖巾
敌	千口攵
抵	扌氐
递	辶丷乛一乛丨丿
迪	辶由
滴	氵亠丷冂十口
蒂	艹亠丷冖巾
狄	犭火
笛	⺮由
嘀	口亠丷冂十口
堤	土日一丨一人
邸	氐阝
嫡	女亠丷冂十口
棣	木乛一一丨冫丿ㄟ
缔	纟亠丷冖巾
谛	讠亠丷冖巾
涤	氵夂朩
荻	艹犭火
娣	女丷乛一乛丨丿
诋	讠氐
氐	氏丶
砥	石氐
镝	钅亠丷冂十口
睇	目丷乛一乛丨丿
坻	土氐
柢	木氐
鞮	革日一丨一人
羝	⺶氐
觌	十乛丶丶大冂见下
籴	入米
骶	骨氐
碲	石亠丷冖巾
禘	礻亠丷冖巾
翟	习习亻亠龶
踶	⻊日一丨一人
菂	艹白勺
髢	一丨一二厶丿丿丿也
玓	王勺
杕	木大
蹢	⻊亠丷冂十口
媂	女亠丷冖巾
提	扌日一丨一人
䃅	石丷丨乛一一一丨
䗖	虫带上冖巾
茋	艹氐
𤧛	王亠丷冖巾
𬱖	由一丿冂人
嗲	口八乂夕夕
点	丨一口灬
电	丨乛一一乛
店	广丨一口
殿	尸艹一八几又
典	丨乛一丨丨一八
颠	十具上八一丿冂人
垫	扌丸土
甸	勹田
惦	忄广丨一口
奠	丷酉大
掂	扌广丨一口
癫	疒十具上八一丿冂人
巅	山十具上八一丿冂人
淀	氵宀一丨一人
滇	氵十具上八
玷	王丨一口
踮	⻊广丨一口
佃	亻田
靛	龶月宀一丨一人
碘	石丨乛一丨丨一八
钿	钅田
簟	⺮西日十
癜	疒尸艹一八几又
坫	土丨一口
阽	阝丨一口
扂	户丨一口
琔	王宀一丨一人
掉	扌丨一日十
调	讠冂土口
屌	尸口巾
雕	冂土口亻亠龶
吊	口巾
钓	钅勺
刁	乛一
叼	口刁
貂	豸刀口
凋	冫冂土口
碉	石冂土口
鲷	鱼冂土口
铫	钅儿冫丿丶
铞	钅口巾
窎	宀八鸟
汈	氵刁
爹	八乂夕夕
蝶	虫世木
跌	⻊失
叠	又又又冖且
碟	石世木
迭	辶失
谍	讠世木
喋	口世木
牒	片世木
堞	土世木
耋	耂匕一厶土
鲽	鱼世木
昳	日失
蹀	⻊世木
瓞	瓜失
垤	土一厶土
绖	纟一厶土
楪	木世木
𫶇	山带上冖巾
定	宀一丨一人
顶	丁一丿冂人
丁	一丨
盯	目丁
订	讠丁
叮	口丁
鼎	目乛一丿丨一丨乛
钉	钅丁
锭	钅宀一丨一人
町	田丁
仃	亻丁
酊	酉丁
腚	月宀一丨一人
玎	王丁
碇	石宀一丨一人
疔	疒丁
啶	口宀一丨一人
耵	耳丁
萣	艹宀一丨一人
丢	丿土厶
铥	钅丿土厶
动	二厶力
东	一乛丨丿丶
洞	氵冂一口
懂	忄艹重
冬	夂丶丶
董	艹重
冻	冫东
栋	木东
咚	口夂丶丶
峒	山冂一口
胴	月冂一口
侗	亻冂一口
恫	忄冂一口
鸫	东鸟
垌	土冂一口
硐	石冂一口
氡	气夂丶丶
胨	月东
岽	山东
𬟽	虫东
都	耂日阝
斗	丶丶十
抖	扌丶丶十
豆	一口丷一
逗	辶一口丷一
兜	丿乛白乛一儿
陡	阝土丨一人
窦	宀八十乛丶丶大
痘	疒一口丷一
蚪	虫丶丶十
蔸	艹白丿乛乛一儿
篼	⺮白丿乛乛一儿
钭	钅丶丶十
读	讠十乛丶丶大
度	广廿又
独	犭虫
毒	龶母
杜	木土
肚	月土
赌	冂人耂日
督	上小又目
渡	氵广廿又
嘟	口耂日阝
堵	土耂日
妒	女户
睹	目耂日
笃	⺮马
渎	氵十乛丶丶大
镀	钅广廿又
犊	牛十乛丶丶大
牍	片十乛丶丶大
蠹	一丨乛一丨冖石虫虫
黩	黑十乛丶丶大
阇	门耂日
芏	艹土
椟	木十乛丶丶大
髑	骨罒勹虫
厾	乛土厶
𬭊	钅木土
断	米乛斤
段	丿丨一一一几又
短	矢一口丷一
端	立山而
锻	钅丿丨一一一几又
缎	纟丿丨一一一几又
煅	火丿丨一一一几又
椴	木丿丨一一一几又
耑	山而
簖	⺮米乛斤
塅	土丿丨一一一几又
瑖	王丿丨一一一几又
对	又寸
队	阝人
堆	土亻亠龶
兑	丷口儿
怼	又寸心
碓	石亻亠龶
祋	礻几又
顿	屯一丿冂人
盾	丿丿十目
蹲	⻊丷酉寸
敦	亠口子攵
沌	氵屯
遁	辶丿丿十目
吨	口屯
钝	钅屯
墩	土亠口子攵
炖	火屯
盹	目屯
惇	忄亠口子
趸	万口丨一人
礅	石亠口子攵
蹾	⻊亠口子攵
砘	石屯
镦	钅亠口子攵
囤	囗屯
多	夕夕
躲	身几木
朵	几木
夺	大寸
堕	阝𠂇月土
哆	口夕夕
跺	⻊几木
踱	⻊广廿又
舵	舟宀匕
咄	口出
剁	几木刂
铎	钅又一一丨
惰	忄𠂇工月
垛	土几木
掇	扌又又又又
哚	口几木
裰	衤又又又又
埵	土垂
饳	饣出
亸	亠口子丷丨乛一一一丨
剟	又又又又刂
驮	马大
㙍	土又又又又
饿	饣我
呃	口厂乛乛
恶	亚心
额	宀夂口一丿冂人
俄	亻我
愕	忄口口亏
鹅	我鸟
噩	王口口口口
娥	女我
厄	厂乛乛
峨	山我
鄂	口口亏阝
遏	辶日勹人乛
扼	扌厂乛乛
鳄	鱼口口亏
蛾	虫我
婀	女阝丁口
讹	讠亻匕
锷	钅口口亏
颚	口口亏一丿冂人
鹗	口口亏鸟
萼	艹口口亏
屙	尸阝丁口
谔	讠口口亏
垩	亚土
腭	月口口亏
莪	艹我
轭	车厂乛乛
苊	艹厂乛乛
锇	钅我
崿	山口口亏
姶	女人一口
涐	氵我
哦	口我
堨	土日勹人乛
𥔲	石口口亏
𫫇	口亚心
嗯	口囗大心
恩	囗大心
摁	扌囗大心
蒽	艹囗大心
而	一丿冂丨丨
儿	丿乛
二	一一
尔	⺈小
耳	一丨丨一一一
饵	饣耳
迩	辶⺈小
贰	弋二冂人
洱	氵耳
珥	王耳
铒	钅耳
鸸	而鸟
陑	阝而
鲕	鱼而
咡	口耳
耏	而丿丿丿
发	乛丿又丶
法	氵土厶
罚	罒讠刂
乏	丿之
伐	亻戈
阀	门亻戈
筏	⺮亻戈
砝	石土厶
珐	王土厶
垡	亻戈土
反	丿丿又
饭	饣丿丿又
翻	丿米田习习
烦	火一丿冂人
凡	几丶
犯	犭乛乛
范	艹氵乛乛
番	丿米田
繁	丿一母攵幺小
返	辶丿丿又
泛	氵乏
帆	巾凡
贩	冂人丿丿又
樊	木乂乂木大
藩	艹氵丿米田
梵	木木凡
幡	巾丿米田
蘩	艹丿一母攵幺小
璠	王丿米田
矾	石凡
畈	田丿丿又
燔	火丿米田
钒	钅凡
氾	氵乛乛
蹯	⻊丿米田
墦	土丿米田
𫔍	钅丿米田
𬸪	丿米田鸟
放	方攵
房	户方
防	阝方
方	丶万
仿	亻方
芳	艹方
访	讠方
妨	女方
坊	土方
纺	纟方
肪	月方
舫	舟方
枋	木方
昉	日方
鲂	鱼方
邡	方阝
钫	钅方
牥	牛方
蚄	虫方
飞	乛丿丶
非	丨一一一丨一一一
费	弗冂人
菲	艹非
废	广乛丿又丶
妃	女己
肥	月巴
啡	口非
匪	匚非
沸	氵弗
肺	月一丨乛丨
绯	纟非
斐	非文
霏	雨非
翡	非习习
扉	户非
吠	口犬
诽	讠非
蜚	非虫
狒	犭弗
腓	月非
悱	忄非
淝	氵月巴
芾	艹一丨乛丨
痱	疒非
榧	木匚非
鲱	鱼非
篚	⺮匚非
朏	月出
棐	非木
镄	钅弗冂人
剕	非刂
𬴂	马非
分	八刀
份	亻八刀
纷	纟八刀
奋	大田
愤	忄十艹冂人
粉	米八刀
氛	气八刀
吩	口八刀
芬	艹八刀
焚	木木火
坟	土文
忿	八刀心
粪	米艹一八
汾	氵八刀
酚	酉八刀
棼	木木八刀
偾	亻十艹冂人
鲼	鱼十艹冂人
棻	艹八刀木
鼢	臼乛丶丶乛丶丶乛八刀
翂	习习八刀
瀵	氵米田艹一八
坋	土八刀
豮	豕十艹冂人
𣸣	氵十艹冂人
风	几乂
封	土土寸
凤	几又
峰	山夂丰
疯	疒几乂
锋	钅夂丰
枫	木几乂
丰	一一一丨
奉	寿上ㄟ一一丨
冯	冫马
缝	纟夂丰辶
逢	辶夂丰
讽	讠几乂
蜂	虫夂丰
烽	火夂丰
俸	亻寿上ㄟ一一丨
沣	氵丰
沨	氵几乂
酆	山丰丰一口丷一阝
葑	艹土土寸
唪	口寿上ㄟ一一丨
砜	石几乂
赗	冂人冂一一目
浲	氵夂丰
崶	山土土寸
否	不口
缶	午凵
服	月卩又
夫	一一丿ㄟ
父	八乂
复	丿一日夂
福	礻一口田
府	广亻寸
副	一口田刂
负	⺈冂人
付	亻寸
富	宀一口田
妇	女彐
附	阝亻寸
伏	亻犬
傅	亻甫寸
浮	氵丿⺍子
扶	扌夫
抚	扌无
符	⺮亻寸
肤	月夫
腹	月丿一日夂
幅	巾一口田
咐	口亻寸
覆	西彳丿一日夂
腐	广亻寸内人
弗	乛一乛丿丨
赴	土丨一人卜
斧	八乂斤
俯	亻广亻寸
赋	冂人一弋止
辅	车甫
芙	艹夫
拂	扌弗
甫	一丨乛一一丨丶
俘	亻丿⺍子
缚	纟甫寸
蝠	虫一口田
敷	甫方攵
脯	月甫
袱	衤亻犬
腑	月广亻寸
辐	车一口田
孚	丿⺍子
驸	马亻寸
釜	八乂干丶丿一
苻	艹亻寸
匐	勹一口田
宓	宀必
阜	丿㠯十
孵	卵丿⺍子
馥	禾日丿一日夂
茀	艹弗
涪	氵立口
茯	艹亻犬
凫	丿乛丶乛几
蚨	虫夫
拊	扌亻寸
蝮	虫丿一日夂
讣	讠卜
黼	业丶丿丨乛丨丿丶甫
趺	⻊夫
怫	忄弗
氟	气弗
蜉	虫丿⺍子
黻	业丶丿丨乛丨丿丶𠂇又丶
麸	龶夂夫
绂	纟𠂇又丶
跗	⻊亻寸
鲋	鱼亻寸
罘	罒不
滏	氵八乂干丶丿一
郛	丿⺍子阝
菔	艹月卩又
桴	木丿⺍子
幞	巾业⺶ㄟ
祓	礻𠂇又丶
呋	口夫
绋	纟弗
莩	艹丿⺍子
赙	冂人甫寸
鄜	广乛丨丨一比左匕阝
芣	艹不
洑	氵亻犬
簠	⺮甫皿
榑	木甫寸
稃	禾丿⺍子
韨	韦𠂇又丶
玞	王夫
砆	石夫
垺	土丿⺍子
㕮	口八乂
㳇	氵八乂
琈	王丿⺍子
𫓧	钅夫
𫖯	儿冫丿丶一丿冂人
尬	尢人丿丨
嘎	口一自戈
伽	亻力口
噶	口艹日勹人乛
旮	九日
咖	口力口
尕	乃小
尜	小大小
轧	车乛
钆	钅乛
戛	一自戈
该	讠亠乛丿人
改	己攵
盖	⺷皿
概	木即左一乛丿乛
丐	一丨一乛
钙	钅丐
溉	氵即左一乛丿乛
赅	冂人亠乛丿人
垓	土亠乛丿人
陔	阝亠乛丿人
戤	乃又皿戈
荄	艹亠乛丿人
晐	日亠乛丿人
𬮿	阝山己
感	戌口心
干	一十
敢	乛耳攵
赶	土丨一人干
甘	廿一
尴	尢丨丨丿一丶皿
杆	木干
肝	月干
竿	⺮干
橄	木乛耳攵
赣	立日十夂工冂人
秆	禾干
柑	木甘
擀	扌十日十人干
玕	王干
淦	氵金
泔	氵甘
矸	石干
坩	土甘
绀	纟甘
苷	艹甘
旰	日干
疳	疒甘
酐	酉干
澉	氵乛耳攵
虷	虫干
鳡	鱼戌口心
㽏	氵人一口甘
刚	冂乂刂
港	氵艹一八巳
钢	钅冂乂
岗	山冂乂
冈	冂乂
缸	缶工
纲	纟冂乂
罡	罒正
杠	木工
肛	月工
筻	⺮更
冮	冫工
矼	石工
堽	土罒正
戆	立日十夂工冂人心
扛	扌工
㭎	木冂乂
鿍	土夂一乛丨
高	亠口冂口
告	⺧口
搞	扌亠口冂口
糕	米⺷灬
稿	禾亠口冂口
膏	亠口冖口月
羔	⺷灬
皋	白大十
镐	钅亠口冂口
睾	丿罒土丷干
篙	⺮亠口冂口
诰	讠⺧口
槁	木亠口冂口
杲	日木
缟	纟亠口冂口
锆	钅⺧口
郜	⺧口阝
藁	艹亠口冂口木
槔	木白大十
筶	⺮⺧口
个	人丨
哥	丁口丁口
各	夂口
格	木夂口
歌	丁口丁口⺈人
革	廿丨乛一一丨
隔	阝一口冂丷一丨
阁	门夂口
葛	艹日勹人乛
割	宀丰口刂
胳	月夂口
戈	一乛丿丶
搁	扌门夂口
鸽	人一口鸟
疙	疒乞
骼	骨夂口
嗝	口一口冂丷一丨
硌	石夂口
咯	口夂口
铬	钅夂口
鬲	一口冂丷一丨
圪	土乞
蛤	虫人一口
舸	舟丁口
膈	月一口冂丷一丨
虼	虫乞
袼	衤夂口
哿	力口丁口
镉	钅一口冂丷一丨
仡	亻乞
饹	饣夂口
塥	土一口冂丷一丨
滆	氵一口冂丷一丨
合	人一口
给	纟人一口
跟	⻊艮
根	木艮
亘	一日一
艮	彐乛丿ㄟ
哏	口艮
茛	艹艮
更	一丨乛一一丿ㄟ
耿	耳火
哽	口更
耕	耒井
羹	⺷灬⺷大
庚	广乛一一丿ㄟ
梗	木更
赓	广乛一一丿ㄟ冂人
埂	土更
鲠	鱼更
绠	纟更
浭	氵更
暅	日忄一日一
颈	乛丶工一丿冂人
鹒	广乛一一丿ㄟ鸟
𬒔	石止月
公	八厶
工	一丨一
功	工力
攻	工攵
宫	宀口口
共	艹一八
供	亻艹一八
恭	艹一八⺗
弓	乛一乛
贡	工冂人
躬	身弓
拱	扌艹一八
龚	龙艹一八
巩	工凡
蚣	虫八厶
觥	⺈用⺌兀
汞	工水
肱	月𠂇厶
珙	王艹一八
䢼	艹一八阝
硔	石艹一八
够	勹口夕夕
狗	犭勹口
构	木勹厶
勾	勹厶
购	冂人勹厶
沟	氵勹厶
钩	钅勹厶
苟	艹勹口
垢	土丿丿一口
篝	⺮一一丨丨一冉
佝	亻勹口
媾	女一一丨丨一冉
枸	木勹口
诟	讠丿丿一口
彀	士冖一弓几又
缑	纟亻乛一矢
遘	辶一一丨丨一冉
鞲	革一一丨丨一冉
笱	⺮勹口
觏	一一丨丨一冉冂见下
岣	山勹口
姤	女丿丿一口
雊	勹口亻亠龶
耇	耂勹口
句	勹口
古	十口
故	十口攵
顾	厂乛乛一丿冂人
股	月几又
姑	女十口
骨	丨乛乛冖月
孤	子瓜
谷	八人口
鼓	士口丷一十又
固	囗十口
估	亻十口
咕	口十口
辜	十口立十
雇	户亻亠龶
蛊	虫皿
菇	艹女十口
汩	氵曰
箍	⺮扌匚巾
锢	钅囗十口
沽	氵十口
贾	西冂人
鹘	骨鸟
臌	月士口丷一十又
牯	牛十口
轱	车十口
鸪	十口鸟
梏	木⺧口
痼	疒囗十口
钴	钅十口
毂	士冖车几又
崮	山囗十口
诂	讠十口
瞽	士口丷一十又目
菰	艹子瓜
蛄	虫十口
羖	⺶几又
觚	⺈用瓜
嘏	十口乛一丨一一乛一又
罟	罒十口
榖	士冖一木几又
酤	酉十口
馉	饣骨
牿	牛⺧口
堌	土囗十口
蓇	艹骨
鲴	鱼囗十口
呱	口瓜
鹄	⺧口鸟
瀔	氵士冖一禾几又
𦙶	月十口
挂	扌土土
瓜	丿丿乛丶ㄟ
刮	千口刂
寡	宀一丿且八刀
卦	土土卜
褂	衤土土卜
剐	口内刂
鸹	千口鸟
诖	讠土土
栝	木千口
胍	月瓜
怪	忄又土
乖	千丨一一匕
拐	扌口力
掴	扌囗玉
夬	乛一丿ㄟ
关	丷天
管	⺮宀㠯
官	宀㠯
观	又冂见下
馆	饣宀㠯
惯	忄毌冂人
冠	冖二儿寸
贯	毌冂人
灌	氵艹口口亻亠龶
罐	缶艹口口亻亠龶
棺	木宀㠯
倌	亻宀㠯
盥	丿丨一一水彐皿
掼	扌毌冂人
涫	氵宀㠯
鳏	鱼罒丨丿丿丶丶
鹳	艹口口亻亠龶鸟
瓘	王艹口口亻亠龶
祼	礻果
琯	王宀㠯
毌	乛乛丨一
筦	⺮宀二儿
蒄	艹冖二儿寸
爟	火艹口口亻亠龶
纶	纟人匕
莞	艹宀二儿
鳤	鱼⺮宀㠯
光	⺌兀
广	丶厂
逛	辶犭王
咣	口⺌兀
犷	犭广
胱	月⺌兀
桄	木⺌兀
洸	氵⺌兀
珖	王⺌兀
垙	土⺌兀
𨐈	车⺌兀
鬼	丿丨乛一一丿乛厶
贵	中一冂人
规	夫冂见下
归	丨丿彐
跪	⻊⺈厂乛乛
柜	木巨
诡	讠⺈厂乛乛
瑰	王鬼
桂	木土土
龟	⺈丨乛一一乛
轨	车九
闺	门土土
圭	土土
桧	木人二厶
刽	人二厶刂
癸	乛丶丿丿ㄟ天
硅	石土土
妫	女为
珪	王土土
皈	白丿丿又
晷	日夂卜口
鲑	鱼土土
刿	山夕刂
鳜	鱼厂丷一乛丨丿⺈人
姽	女⺈厂乛乛
簋	⺮艮皿
庋	广十又
宄	宀九
匦	匚车九
邽	土土阝
鬶	夫冂见下一口冂丷一丨
炅	日火
筀	⺮土土
滚	氵亠八厶𧘇
棍	木日比左匕
衮	亠八厶𧘇
鲧	鱼丿幺小
磙	石亠八厶𧘇
辊	车日比左匕
绲	纟日比左匕
过	辶寸
国	囗玉
果	丨乛一一一丨丿ㄟ
郭	亠口子阝
锅	钅口内
裹	亠果𧘇
蝈	虫囗玉
聒	耳千口
帼	巾囗玉
椁	木亠口子
虢	丿⺍寸虍几
埚	土口内
呙	口内
崞	山亠口子
腘	月囗玉
馘	丷一自戈口一
粿	米果
蜾	虫果
馃	饣果
涡	氵口内
𬇹	氵囗玉
哈	口人一口
铪	钅人一口
还	辶不
海	氵丿一母
孩	子亠乛丿人
害	宀丰口
骇	马亠乛丿人
嗨	口氵丿一母
骸	骨亠乛丿人
亥	亠乛丿人
咳	口亠乛丿人
嗐	口宀丰口
氦	气亠乛丿人
醢	酉𠂇口皿
胲	月亠乛丿人
咍	口厶口
汉	氵又
寒	宀一一丨丨一八丶丶
喊	口戌口
韩	十日十韦
汗	氵干
含	人丶乛口
涵	氵了冫丿丶凵
翰	十日十人习习
憾	忄戌口心
罕	冖八干
撼	扌戌口心
悍	忄日干
瀚	氵十日十人习习
函	了冫丿丶凵
憨	乛耳攵心
旱	日干
酣	酉甘
颔	人丶乛口一丿冂人
邯	甘阝
捍	扌日干
鼾	自田一丿丨干
晗	日人丶乛口
菡	艹了冫丿丶凵
焊	火日干
顸	干一丿冂人
邗	干阝
焓	火人丶乛口
蚶	虫甘
扞	扌干
撖	扌乛耳攵
暵	日廿丨乛一一一丿ㄟ
浛	氵人丶乛口
琀	王人丶乛口
㘎	口门乛耳攵
垾	土日干
崡	山了冫丿丶凵
嵅	山戌口
蔊	艹火日干
行	彳亍
航	舟亠几
杭	木亠几
夯	大力
沆	氵亠几
颃	亠几一丿冂人
绗	纟彳亍
吭	口亠几
巷	艹一八巳
好	女子
号	口一乛
毫	亠口冖毛
豪	亠口冖豕
浩	氵⺧口
耗	耒毛
昊	日天
郝	土丿丨丿丶阝
嚎	口亠口冖豕
皓	白⺧口
壕	土亠口冖豕
嗥	口白大十
颢	日亠口小一丿冂人
濠	氵亠口冖豕
蒿	艹亠口冂口
灏	氵日亠口小一丿冂人
貉	豸夂口
蚝	虫毛
薅	艹女厂二乛丿ㄟ寸
皞	白白大十
淏	氵日天
嚆	口艹亠口冂口
鄗	亠口冂口阝
和	禾口
何	亻丁口
喝	口日勹人乛
呵	口丁口
河	氵丁口
赫	土丿丨丿丶土丿丨丿丶
核	木亠乛丿人
贺	力口冂人
盒	人一口皿
荷	艹亻丁口
鹤	丶乛丿丨亠龶鸟
禾	丿木
褐	衤日勹人乛
嗬	口艹亻丁口
壑	丨一冖一八人口又土
阖	门土厶皿
吓	口下
涸	氵囗十口
劾	亠乛丿人力
颌	人一口一丿冂人
阂	门亠乛丿人
诃	讠丁口
郃	人一口阝
纥	纟乞
龢	人一口口口冂艹禾
鞨	革日勹人乛
翮	一口冂丷一丨习习
曷	日勹人乛
龁	止人凵乞
盍	土厶皿
菏	艹氵丁口
盉	禾皿
饸	饣人一口
熇	火亠口冂口
鹖	日勹人乛鸟
翯	习习亠口冂口
垎	土夂口
隺	丶乛丿丨亠龶
𬌗	牙人一口
黑	丨乛丶丿一丨一一灬
嘿	口黑
𬭶	钅黑
很	彳艮
狠	犭艮
恨	忄艮
痕	疒艮
𬣳	讠艮
哼	口亠口了
横	木艹一由八
衡	彳⺈田大亍
恒	忄一日一
亨	亠口了
蘅	艹彳⺈田大亍
珩	王彳亍
姮	女一日一
桁	木彳亍
鸻	彳亍鸟
堼	土土寸土
红	纟工
轰	车又又
洪	氵艹一八
虹	虫工
宏	宀𠂇厶
鸿	氵工鸟
哄	口艹一八
弘	弓厶
烘	火艹一八
泓	氵弓厶
闳	门𠂇厶
讧	讠工
薨	艹罒冖歹匕
訇	勹亠一一口
荭	艹纟工
纮	纟𠂇厶
吽	口牛
竑	立𠂇厶
蕻	艹一丨一二厶艹一八
翃	𠂇厶习习
黉	⺍冖艹一由八
唝	口工冂人
玒	王工
谼	八人口艹一八
𫟹	钅艹一八
𬭎	钅宀𠂇厶
后	丿丿一口
候	亻丨乛一矢
厚	厂日子
吼	口子乛
侯	亻乛一矢
猴	犭亻乛一矢
喉	口亻乛一矢
逅	辶丿丿一口
篌	⺮亻乛一矢
瘊	疒亻乛一矢
鲎	⺍冖鱼
堠	土亻乛一矢
垕	丿丿一口土
齁	自田一丿丨勹口
骺	骨丿丿一口
糇	米亻乛一矢
郈	丿丿一口阝
鲘	鱼丿丿一口
𬭤	钅亻乛一矢
乎	丿丶丿一丨
呼	口乎
忽	勿心
护	扌户
胡	十口月
虎	虍几
湖	氵十口月
糊	米十口月
户	丶尸
互	一乛乛一
狐	犭瓜
壶	士冖业
蝴	虫十口月
惚	忄勿心
弧	弓瓜
唬	口虍几
葫	艹十口月
沪	氵户
扈	户口巴
瑚	王十口月
琥	王虍几
浒	氵讠午
斛	⺈用丶丶十
囫	囗勿
祜	礻十口
醐	酉十口月
唿	口勿心
猢	犭十口月
笏	⺮勿
瓠	大亏瓜
槲	木⺈用丶丶十
怙	忄十口
煳	火十口月
鹕	十口月鸟
滹	氵虍乎
觳	士冖一⺈用几又
岵	山十口
烀	火乎
鄠	雨亏阝
戽	户丶丶十
縠	士冖一丿幺小几又
冱	冫互
鹱	鸟艹亻亠龶又
淴	氵勿心
昒	日勿
鳠	鱼艹亻亠龶又
嫭	女虍乎
轷	车乎
昈	日户
话	讠千口
花	艹亻匕
化	亻匕
华	亻匕十
划	戈刂
画	一田凵
滑	氵骨
哗	口亻匕十
猾	犭骨
桦	木亻匕十
骅	马亻匕十
婳	女一田凵
铧	钅亻匕十
砉	丰石
觟	⺈用土土
怀	忄不
坏	土不
淮	氵亻亠龶
槐	木鬼
徊	彳囗口
踝	⻊果
换	扌⺈丨乛大
缓	纟丿⺍一𠂇又
环	王不
幻	幺乛
唤	口⺈丨乛大
欢	又⺈人
患	串心
焕	火⺈丨乛大
桓	木一日一
鬟	一丨一二厶丿丿丿罒一口𧘇
宦	宀臣
寰	宀罒一口𧘇
浣	氵宀二儿
痪	疒⺈丨乛大
涣	氵⺈丨乛大
奂	⺈丨乛大
圜	囗罒一口𧘇
豢	龹豕
獾	犭艹口口亻亠龶
洹	氵一日一
嬛	女罒一口𧘇
缳	纟罒一口𧘇
萑	艹亻亠龶
鲩	鱼宀二儿
郇	勹日阝
漶	氵串心
逭	辶宀㠯
擐	扌罒一口𧘇
锾	钅丿⺍一𠂇又
镮	钅罒一口𧘇
澴	氵罒一口𧘇
鹮	罒一口𧘇鸟
貆	豸一日一
峘	山一日一
㬊	日丿⺍一𠂇又
荁	艹一日一
𤩽	王十冂丷干犬
𬘫	纟宀二儿
黄	艹一由八
皇	白王
晃	日⺌兀
慌	忄艹亡丿丨乛
荒	艹亡丿丨乛
恍	忄⺌兀
谎	讠艹亡丿丨乛
惶	忄白王
凰	几白王
煌	火白王
簧	⺮艹一由八
徨	彳白王
蝗	虫白王
幌	巾日⺌兀
潢	氵艹一由八
璜	王艹一由八
遑	辶白王
磺	石艹一由八
隍	阝白王
肓	亡月
湟	氵白王
蟥	虫艹一由八
篁	⺮白王
鳇	鱼白王
滉	氵日⺌兀
喤	口白王
癀	疒艹一由八
锽	钅白王
艎	舟白王
瑝	王白王
媓	女白王
㿠	白⺌兀
𨱑	钅艹一由八
会	人二厶
回	囗口
挥	扌冖车
灰	𠂇火
慧	丰丰彐心
辉	⺌兀冖车
恢	忄𠂇火
毁	臼工几又
悔	忄丿一母
惠	一丨乛一一丨一丶心
汇	氵匚
绘	纟人二厶
徽	彳山一幺小攵
讳	讠韦
晖	日冖车
晦	日丿一母
贿	冂人𠂇月
秽	禾山夕
卉	十廾
麾	广木木毛
诲	讠丿一母
蕙	艹一丨乛一一丨一丶心
彗	丰丰彐
诙	讠𠂇火
喙	口乛乛豕
荟	艹人二厶
烩	火人二厶
虺	兀虫
蛔	虫囗口
珲	王冖车
咴	口𠂇火
茴	艹囗口
恚	土土心
洄	氵囗口
袆	衤韦
隳	阝𠂇工月人⺗
翚	习习冖车
翙	山夕习习
浍	氵人二厶
蟪	虫一丨乛一一丨一丶心
硊	石⺈厂乛乛
橞	木一丨乛一一丨一丶心
哕	口山夕
溃	氵中一冂人
㧑	扌为
烠	火𠂇月
𬤝	讠一丨乛一一丨一丶心
𬭬	钅丰丰彐
婚	女氏日
混	氵日比左匕
魂	二厶鬼
昏	氏日
浑	氵冖车
荤	艹冖车
馄	饣日比左匕
诨	讠冖车
阍	门氏日
溷	氵囗豕
惛	忄氏日
碈	石氏日
或	戈口一
活	氵千口
火	丶丿人
伙	亻火
获	艹犭犬
惑	戈口一心
货	亻匕冂人
祸	礻口内
霍	雨亻亠龶
豁	宀丰口八人口
夥	果夕夕
嚯	口雨亻亠龶
藿	艹雨亻亠龶
镬	钅艹亻亠龶又
蠖	虫艹亻亠龶又
攉	扌雨亻亠龶
钬	钅火
嚄	口艹亻亠龶又
锪	钅勿心
劐	艹亻亠龶又刂
濩	氵艹亻亠龶又
耠	耒人一口
漷	氵亠口子阝
㸌	火雨亻亠龶
佸	亻千口
𬴃	马丰石
级	纟及
集	亻亠龶木
几	丿乛
及	丿乛ㄟ
机	木几
记	讠己
季	禾子
击	一一丨凵
急	⺈彐心
系	丿幺小
即	即左卩
既	即左一乛丿乛
极	木及
计	讠十
激	氵白方攵
继	纟米乛
基	其上八土
己	乛一乛
际	阝二小
纪	纟己
技	扌十又
济	氵文丿丨
迹	辶亠丿丨丿丶
吉	士口
积	禾口八
鸡	又鸟
寂	宀上小又
挤	扌文丿丨
疾	疒矢
忌	己心
姬	女匚丨口丨
绩	纟龶冂人
祭	丿乛丶丶二小
肌	月几
寄	宀大丁口
辑	车口耳
籍	⺮耒艹一日
圾	土及
妓	女十又
嫉	女疒矢
饥	饣几
剂	文丿丨刂
奇	大丁口
脊	冫丿丶人月
稽	禾尤匕日
叽	口几
唧	口即左卩
讥	讠几
藉	艹耒艹一日
冀	丨一一匕田艹一八
戟	十日十戈
棘	一丨乛丨丿ㄟ一丨乛丨丿ㄟ
缉	纟口耳
悸	忄禾子
羁	罒革马
玑	王几
伎	亻十又
霁	雨文丿丨
矶	石几
髻	一丨一二厶丿丿丿士口
稷	禾田八夂
岌	山及
汲	氵及
畸	田大丁口
笈	⺮及
觊	山己冂见下
骥	马丨一一匕田艹一八
嵇	禾尤山
蓟	艹鱼刂
箕	⺮其上八
佶	亻士口
瘠	疒冫丿丶人月
畿	幺幺戈田
犄	牛大丁口
亟	了口又一
跻	⻊文丿丨
殛	歹了口又一
暨	即左一乛丿乛日一
鲫	鱼即左卩
偈	亻日勹人乛
齑	文韭丿丨
蒺	艹疒矢
芨	艹及
屐	尸彳十又
荠	艹文丿丨
楫	木口耳
赍	十冖人人冂人
乩	丨一口乛
麂	广乛丨丨一比左匕几
笄	⺮开
芰	艹十又
墼	车凵几又土
鹡	冫丿丶人月鸟
剞	大丁口刂
戢	口戈丨丨一一一
虮	虫几
伋	亻及
垍	土自
掎	扌大丁口
洎	氵自
跽	⻊己心
嵴	山冫丿丶人月
鲚	鱼文丿丨
蕺	艹口戈丨丨一一一
罽	罒厂火火刂
蹐	⻊冫丿丶人月
姞	女士口
漈	氵丿乛丶丶二小
穄	禾丿乛丶丶二小
耤	耒艹一日
觭	⺈用大丁口
惎	其上八心
期	其上八月
鱾	鱼己
㴔	氵⺈彐心
堲	即左卩土
徛	彳大丁口
枅	木开
瀱	氵罒厂火火刂
𪟝	龶冂人力
𫌀	衤龶冂人
𫓯	钅土土
𫓹	钅其上八
𬯀	阝文丿丨
𬶨	即左一乛丿乛鱼
𬶭	鱼丿乛丶丶二小
家	宀豕
加	力口
价	亻人丿丨
假	亻乛一丨一一乛一又
架	力口木
甲	丨乛一一丨
佳	亻土土
夹	一丶丿一丿ㄟ
嘉	士口丷一力口
嫁	女宀豕
驾	力口马
颊	夹一丿冂人
迦	辶力口
茄	艹力口
稼	禾宀豕
枷	木力口
珈	王力口
袈	力口亠𧘇
葭	艹乛一丨一一乛一又
浃	氵夹
胛	月甲
痂	疒力口
笳	⺮力口
岬	山甲
槚	木西冂人
钾	钅甲
荚	艹夹
郏	夹阝
铗	钅夹
跏	⻊力口
蛱	虫夹
恝	丰刀心
斝	口口冖丶丶十
镓	钅宀豕
瘕	疒乛一丨一一乛一又
泇	氵力口
𬂩	木夹
见	冂见下
间	门日
剑	人一⺍一刂
件	亻牛
建	廴聿
键	钅聿廴
渐	氵车斤
简	⺮门日
坚	丨丨又土
肩	户月
箭	⺮丷一月刂
舰	舟冂见下
尖	小大
监	丨丨丿一丶皿
健	亻聿廴
检	木人一⺍一
减	冫戌口
奸	女干
艰	又艮
兼	丷一乛一一丨丨丿ㄟ
鉴	丨丨丿一丶金
贱	冂人戋
捡	扌人一⺍一
剪	丷一月刂刀
溅	氵冂人戋
践	⻊戋
荐	艹𠂇丨子
歼	歹千
拣	扌一乛乛丿丶
煎	丷一月刂灬
俭	亻人一⺍一
涧	氵门日
茧	艹虫
谏	讠柬
柬	一丨乛丶丿一丨丿ㄟ
笺	⺮戋
缄	纟戌口
戬	亚日戈
锏	钅门日
碱	石戌口
睑	目人一⺍一
翦	丷一月刂习习
饯	饣戋
蹇	宀一一丨丨一八口丨一人
僭	亻一乛丿乛一乛丿乛日
菅	艹宀㠯
毽	毛聿廴
腱	月聿廴
謇	宀一一丨丨一八亠一一口
蒹	艹丷一乛一一丨丨丿ㄟ
戋	一一乛丿丶
槛	木丨丨丿一丶皿
鞯	革艹𠂇丨子
笕	⺮冂见下
鹣	丷一乛一一丨丨丿ㄟ鸟
搛	扌丷一乛一一丨丨丿ㄟ
缣	纟丷一乛一一丨丨丿ㄟ
鞬	革聿廴
湔	氵丷一月刂
裥	衤门日
枧	木冂见下
鲣	鱼丨丨又土
趼	⻊开
谫	讠丷一月刂刀
踺	⻊聿廴
楗	木聿廴
暕	日柬
牮	亻弋牛
篯	⺮钅戋
犍	牛聿廴
鳒	鱼丷一乛一一丨丨丿ㄟ
𬣡	讠戋
将	冫丨夕寸
江	氵工
讲	讠井
降	阝夂一乛丨
蒋	艹冫丨夕寸
奖	冫丨夕大
僵	亻一田一田一
姜	⺷女
疆	弓土一田一田一
匠	匚斤
浆	冫丨夕水
酱	冫丨夕酉
缰	纟一田一田一
绛	纟夂一乛丨
桨	冫丨夕木
犟	弓口虫牛
糨	米弓口虫
豇	一口丷一工
茳	艹氵工
礓	石一田一田一
洚	氵夂一乛丨
耩	耒一一丨丨一冉
膙	月弓口虫
鳉	鱼冫丨夕寸
弶	弓亠口小
强	弓口虫
叫	口乛丨
教	耂子攵
交	亠八乂
脚	月土厶卩
角	⺈用
较	车亠八乂
娇	女夭丿丨
焦	亻亠龶灬
骄	马夭丿丨
轿	车夭丿丨
搅	扌⺍冖冂见下
狡	犭亠八乂
郊	亠八乂阝
胶	月亠八乂
觉	⺍冖冂见下
嚼	口丿⺍罒即左寸
绞	纟亠八乂
剿	乛乛乛果刂
浇	氵一乛丿兀
缴	纟白方攵
蛟	虫亠八乂
椒	木上小又
侥	亻一乛丿兀
矫	矢夭丿丨
饺	饣亠八乂
蕉	艹亻亠龶灬
校	木亠八乂
礁	石亻亠龶灬
皎	白亠八乂
窖	宀八⺧口
跤	⻊亠八乂
佼	亻亠八乂
姣	女亠八乂
酵	酉耂子
鲛	鱼亠八乂
艽	艹九
湫	氵禾火
醮	酉亻亠龶灬
铰	钅亠八乂
峤	山夭丿丨
茭	艹亠八乂
徼	彳白方攵
鹪	亻亠龶灬鸟
敫	白方攵
噍	口亻亠龶灬
僬	亻亻亠龶灬
峧	山亠八乂
滘	氵冖八工口
燋	火亻亠龶灬
藠	艹白白白
皦	白白方攵
斠	一一丨丨一冉丶丶十
璬	王白方攵
皭	白丿⺍罒即左寸
恔	忄亠八乂
䴔	亠八乂鸟
漖	氵耂子攵
接	扌立女
解	⺈用刀牛
姐	女且
结	纟士口
界	田人丿丨
节	艹卩
杰	木灬
街	彳土土亍
借	亻艹一日
介	人丿丨
阶	阝人丿丨
洁	氵士口
戒	戈廾
皆	比左匕白
劫	土厶力
截	十戈亻亠龶
捷	扌一乛一一丨一人
揭	扌日勹人乛
竭	立日勹人乛
届	尸由
婕	女一乛一一丨一人
睫	目一乛一一丨一人
诫	讠戈廾
桀	夕一乛丨木
芥	艹人丿丨
桔	木士口
诘	讠士口
颉	士口一丿冂人
嗟	口⺶工
孑	乛丨一
羯	⺶日勹人乛
拮	扌士口
秸	禾士口
玠	王人丿丨
碣	石日勹人乛
讦	讠干
疥	疒人丿丨
喈	口比左匕白
蚧	虫人丿丨
疖	疒卩
絜	丰刀幺小
檞	木⺈用刀牛
劼	士口力
骱	骨人丿丨
鲒	鱼士口
褯	衤广廿巾
湝	氵比左匕白
岊	巴山
楷	木比左匕白
㛃	丰刀女
悈	忄戈廾
蜐	虫土厶力
进	辶井
今	人丶乛
金	人干丶丿一
紧	丨丨又幺小
近	辶斤
尽	尺丶丶
仅	亻又
禁	木木二小
劲	乛丶工力
锦	钅白巾
巾	丨乛丨
筋	⺮月力
津	氵聿
晋	亚日
斤	丿丿一丨
谨	讠廿丨乛一一一丨一
浸	氵彐冖又
襟	衤木木二小
矜	龴乛丨丿人丶乛
瑾	王廿丨乛一一一丨一
烬	火尺丶丶
靳	革斤
噤	口木木二小
觐	廿丨乛一一一丨一冂见下
妗	女人丶乛
缙	纟亚日
堇	廿丨乛一一一丨一
槿	木廿丨乛一一一丨一
衿	衤人丶乛
荩	艹尺丶丶
馑	饣廿丨乛一一一丨一
卺	了乛丿ㄟ一乛乛
瑨	王亚日
廑	广廿丨乛一一一丨一
琎	王井辶
赆	冂人尺丶丶
溍	氵亚日
祲	礻亻彐冖又
浕	氵尺丶丶
墐	土廿丨乛一一一丨一
殣	歹廿丨乛一一一丨一
珒	王聿
𬬱	钅斤
经	纟乛丶工
惊	忄亠口小
竟	立日儿
静	龶月⺈乛一一丨
精	米龶月
睛	目龶月
警	艹勹口攵亠一一口
京	亠口小
境	土立日儿
景	日亠口小
敬	艹勹口攵
镜	钅立日儿
晶	日日日
净	冫⺈乛一一丨
径	彳乛丶工
竞	立口儿
井	一一丿丨
靖	立龶月
荆	艹开刂
菁	艹龶月
阱	阝井
兢	十口儿十口儿
憬	忄日亠口小
婧	女龶月
鲸	鱼亠口小
茎	艹乛丶工
丼	井丶
旌	方丿一生
痉	疒乛丶工
泾	氵乛丶工
迳	辶乛丶工
璟	王日亠口小
胫	月乛丶工
儆	亻艹勹口攵
靓	龶月冂见下
粳	米更
獍	犭立日儿
刭	乛丶工刂
腈	月龶月
肼	月井
倞	亻亠口小
璥	王艹勹口攵
麖	广乛丨丨一比左匕亠口小
鼱	臼乛丶丶乛丶丶乛龶月
猄	犭亠口小
䴖	龶月鸟
汫	氵井
竫	立⺈乛一一丨
囧	囗八丨乛
炯	火冂口
窘	宀八尹口
迥	辶冂口
颎	匕火一丿冂人
扃	户冂口
冏	冂八口
坰	土冂口
泂	氵冂口
䌹	纟冂口
𬳶	马冂口
就	亠口小尤
酒	氵酉
久	丿乛ㄟ
九	丿乛
究	宀八九
救	求攵
旧	丨日
舅	臼田力
纠	纟乛丨
疚	疒久
揪	扌禾火
咎	夂卜口
鹫	亠口小尤鸟
鸠	九鸟
啾	口禾火
臼	丿丨一乛一一
灸	久火
赳	土丨一人乛丨
厩	厂即左一乛丿乛
柩	木匚久
玖	王久
韭	非一
阄	门⺈丨乛一一乛
僦	亻亠口小尤
鬏	一丨一二厶丿丿丿禾火
桕	木臼
氿	氵九
㠇	山亠口小尤
居	尸十口
举	⺍一八一一丨
局	尸乛口
巨	匚乛一
具	具上八
据	扌尸十口
聚	耳又亻丿丿丿ㄟ
剧	尸十口刂
距	⻊巨
惧	忄具上八
拒	扌巨
俱	亻具上八
矩	矢巨
菊	艹勹米
拘	扌勹口
沮	氵且
鞠	革勹米
狙	犭且
橘	木龴乛丨丿冂八口
驹	马勹口
飓	几乂具上八
锯	钅尸十口
咀	口且
踞	⻊尸十口
炬	火巨
掬	扌勹米
遽	辶虍豕
倨	亻尸十口
雎	且亻亠龶
钜	钅巨
踽	⻊禹
裾	衤尸十口
琚	王尸十口
疽	疒且
莒	艹口口
龃	止人凵且
苣	艹巨
榉	木⺍一八一一丨
讵	讠巨
苴	艹且
鞫	革勹亠一一口
焗	火尸乛口
椐	木尸十口
锔	钅尸乛口
筥	⺮口口
屦	尸彳米女
窭	宀八米女
醵	酉虍豕
蒟	艹立勹口
犋	牛具上八
澽	氵虍豕
娵	女耳又
秬	禾巨
崌	山尸十口
岠	山巨
砠	石且
腒	月尸十口
弆	土厶廾
泃	氵勹口
岨	山且
趄	土丨一人且
䴗	目犬鸟
𬶋	鱼勹口
卷	龹乛乛
娟	女口月
倦	亻龹乛乛
捐	扌口月
眷	龹目
绢	纟口月
鹃	口月鸟
涓	氵口月
圈	囗龹乛乛
隽	亻亠龶乃
镌	钅亻亠龶乃
蠲	丷一八皿罒勹虫
狷	犭口月
鄄	西土阝
锩	钅龹乛乛
桊	龹木
焆	火口月
绝	纟⺈巴
决	冫夬guài
爵	丿⺍罒即左寸
诀	讠夬guài
掘	扌尸出
厥	厂丷一乛丨丿⺈人
倔	亻尸出
撅	扌厂丷一乛丨丿⺈人
珏	王玉
崛	山尸出
抉	扌夬guài
噘	口厂丷一乛丨丿⺈人
攫	扌目目亻亠龶又
谲	讠龴乛丨丿冂八口
獗	犭厂丷一乛丨丿⺈人
蹶	⻊厂丷一乛丨丿⺈人
傕	亻丶乛丿丨亠龶
蕨	艹厂丷一乛丨丿⺈人
矍	目目亻亠龶又
橛	木厂丷一乛丨丿⺈人
镢	钅厂丷一乛丨丿⺈人
玦	王夬guài
孓	乛丨ㄟ
桷	木⺈用
觖	⺈用夬guài
爝	火丿⺍罒即左寸
劂	厂丷一乛丨丿⺈人刂
玃	犭目目亻亠龶又
砄	石夬guài
㵐	氵厂丷一乛丨丿⺈人
𫔎	钅龴乛丨丿冂八口
𫘝	马夬guài
军	冖车
君	尹口
俊	亻厶八夂
均	土勹冫
郡	尹口阝
峻	山厶八夂
钧	钅勹冫
骏	马厶八夂
菌	艹囗禾
竣	立厶八夂
浚	氵厶八夂
珺	王尹口
麇	广乛丨丨一比左匕禾
皲	冖车乛丿丨又
焌	火厶八夂
葰	艹亻厶八夂
捃	扌尹口
畯	田厶八夂
莙	艹尹口
晙	日厶八夂
筠	⺮土勹冫
鲪	鱼尹口
䐃	月囗禾
卡	上卜
喀	口宀夂口
咔	口上卜
胩	月上卜
开	一廾
凯	山己几
慨	忄即左一乛丿乛
铠	钅山己
恺	忄山己
揩	扌比左匕白
锴	钅比左匕白
忾	忄气
闿	门山己
剀	山己刂
垲	土山己
锎	钅门开
炌	火人丿丨
蒈	艹比左匕白
看	龵目
堪	土其上八乛
砍	石⺈人
刊	干刂
侃	亻口丿丨乛
坎	土⺈人
勘	其上八乛力
阚	门乛耳攵
瞰	目乛耳攵
龛	人一口龙
戡	其上八乛戈
崁	山土⺈人
莰	艹土⺈人
衎	彳干亍
磡	石其上八乛力
嵁	山其上八乛
墈	土其上八乛力
抗	扌亠几
康	广乛一一丨冫丿ㄟ
亢	亠几
炕	火亠几
慷	忄广乛一一丨冫丿ㄟ
糠	米广乛一一丨冫丿ㄟ
伉	亻亠几
钪	钅亠几
闶	门亠几
𡐓	土广乛一一丨冫丿ㄟ
𩾌	鱼广乛一一丨冫丿ㄟ
靠	⺧口非
考	耂一乛
烤	火耂一乛
铐	钅耂一乛
拷	扌耂一乛
犒	牛亠口冂口
尻	尸九
栲	木耂一乛
㸆	火⺧口非
洘	氵耂一乛
可	丁口
刻	亠乛丿人刂
克	十口儿
客	宀夂口
科	禾丶丶十
课	讠果
颗	果一丿冂人
渴	氵日勹人乛
柯	木丁口
棵	木果
壳	士冖几
氪	气十口儿
磕	石土厶皿
嗑	口土厶皿
珂	王丁口
苛	艹丁口
轲	车丁口
瞌	目土厶皿
坷	土丁口
恪	忄夂口
蝌	虫禾丶丶十
颏	亠乛丿人一丿冂人
窠	宀八果
稞	禾果
溘	氵土厶皿
疴	疒丁口
岢	山丁口
锞	钅果
髁	骨果
骒	马果
缂	纟革
牁	爿丁口
匼	匚人一口
炣	火丁口
剋	十口儿刂
肯	止月
恳	艮心
啃	口止月
垦	艮土
裉	衤艮
坑	土亠几
铿	钅丨丨又土
硁	石乛丶工
空	宀八工
恐	工凡心
控	扌宀八工
孔	子乛
崆	山宀八工
箜	⺮宀八工
倥	亻宀八工
硿	石宀八工
埪	土宀八工
口	丨乛一
扣	扌口
寇	宀二儿丨一又
叩	口卩
抠	扌匚乂
蔻	艹宀二儿丨一又
芤	艹子乛
筘	⺮扌口
眍	目匚乂
𫸩	弓匚乂
苦	艹十口
哭	口口犬
酷	酉⺧口
库	广车
裤	衤广车
枯	木十口
骷	骨十口
窟	宀八尸出
绔	纟大亏
喾	⺍冖⺧口
刳	大亏刂
矻	石乞
圐	囗罒方
夸	大亏
跨	⻊大亏
垮	土大亏
胯	月大亏
挎	扌大亏
侉	亻大亏
姱	女大亏
快	忄夬guài
块	土夬guài
筷	⺮忄夬guài
蒯	艹月月刂
哙	口人二厶
侩	亻人二厶
脍	月人二厶
狯	犭人二厶
郐	人二厶阝
鲙	鱼人二厶
㧟	扌氵匚
宽	宀艹冂见下
款	士二小⺈人
髋	骨宀艹冂见下
况	冫口儿
狂	犭王
矿	石广
旷	日广
眶	目匚王
框	木匚王
匡	匚王
筐	⺮匚王
哐	口匚王
邝	广阝
诳	讠犭王
诓	讠匚王
圹	土广
纩	纟广
贶	冂人口儿
夼	大川
洭	氵匚王
𫛭	犭王鸟
亏	二乛
愧	忄鬼
盔	𠂇火皿
魁	鬼丶丶十
窥	宀八夫冂见下
奎	大土土
葵	艹乛丶丿丿ㄟ天
傀	亻鬼
睽	目乛丶丿丿ㄟ天
馈	饣中一冂人
逵	辶土八土
馗	九丷一自
匮	匚中一冂人
喟	口田月
夔	丷一自止巳八夂
篑	⺮中一冂人
岿	山丨丿彐
揆	扌乛丶丿丿ㄟ天
聩	耳中一冂人
跬	⻊土土
愦	忄中一冂人
悝	忄里
蝰	虫大土土
暌	日乛丶丿丿ㄟ天
蒉	艹中一冂人
櫆	木鬼丶丶十
骙	马乛丶丿丿ㄟ天
喹	口大土土
煃	火大土土
戣	乛丶丿丿ㄟ天戈
𫠆	十又一丿冂人
困	囗木
昆	日比左匕
坤	土申
捆	扌囗木
鲲	鱼日比左匕
琨	王日比左匕
锟	钅日比左匕
髡	一丨一二厶丿丿丿兀
阃	门囗木
悃	忄囗木
堃	方方土
焜	火日比左匕
壸	士冖亚
鹍	日比左匕鸟
裈	衤冖车
醌	酉日比左匕
婫	女日比左匕
括	扌千口
扩	扌广
阔	门氵千口
廓	广亠口子阝
蛞	虫千口
啦	口扌立
拉	扌立
辣	立𠂇束
垃	土立
腊	月艹一日
喇	口束刂
蜡	虫艹一日
落	艹氵夂口
剌	束刂
邋	辶乛乛乛囗乂乛丶丶乛丶丶乛
旯	日九
瘌	疒束刂
砬	石立
镴	钅乛乛乛囗乂乛丶丶乛丶丶乛
蝲	虫束刂
鞡	革扌立
𬶟	鱼束刂
来	一丶丿一丨丿ㄟ
莱	艹来
赖	束⺈冂人
籁	⺮束⺈冂人
睐	目来
癞	疒束⺈冂人
濑	氵束⺈冂人
徕	彳来
崃	山来
涞	氵来
赉	来冂人
俫	亻来
铼	钅来
梾	木来
蓝	艹丨丨丿一丶皿
烂	火丷三
懒	忄束⺈冂人
拦	扌丷三
篮	⺮丨丨丿一丶皿
岚	山几乂
兰	丷三
栏	木丷三
览	丨丨丿一丶冂见下
澜	氵门柬
揽	扌丨丨丿一丶冂见下
滥	氵丨丨丿一丶皿
婪	木木女
阑	门柬
榄	木丨丨丿一丶冂见下
斓	文门柬
缆	纟丨丨丿一丶冂见下
褴	衤丨丨丿一丶皿
谰	讠门柬
罱	罒十冂丷干
襕	衤门柬
镧	钅门柬
漤	氵木木女
𬒗	石丨丨丿一丶冂见下
狼	犭良
浪	氵良
郎	丶即左阝
朗	丶即左月
廊	广丶即左阝
螂	虫丶即左阝
琅	王良
啷	口丶即左阝
榔	木丶即左阝
锒	钅良
阆	门良
烺	火良
蒗	艹氵良
莨	艹良
稂	禾良
崀	山良
㫰	日良
㮾	丶即左月木
埌	土良
塱	丶即左月土
桹	木良
筤	⺮良
蓢	艹丶即左月
老	耂匕
劳	艹冖力
牢	宀牛
姥	女耂匕
捞	扌艹冖力
唠	口艹冖力
佬	亻耂匕
烙	火夂口
酪	酉夂口
涝	氵艹冖力
崂	山艹冖力
嫪	女习习人丿丿丿
痨	疒艹冖力
醪	酉习习人丿丿丿
栳	木耂匕
铑	钅耂匕
耢	耒艹冖力
荖	艹耂匕
铹	钅艹冖力
络	纟夂口
𫭼	土艹冖力
了	乛丨
乐	丿乛丨丿丶
勒	革力
叻	口力
泐	氵阝力
鳓	鱼革力
仂	亻力
簕	⺮革力
嘞	口革力
雷	雨田
类	米大
泪	氵目
累	田幺小
蕾	艹雨田
磊	石石石
垒	厶厶厶土
擂	扌雨田
肋	月力
儡	亻田田田
镭	钅雨田
羸	亡口月羊凡
檑	木雨田
耒	丰丿ㄟ
诔	讠耒
嫘	女田幺小
酹	酉丿⺍寸
缧	纟田幺小
礌	石雨田
罍	田田田缶
藟	艹田田田
癗	疒雨田
冷	冫人丶龴
愣	忄罒方
楞	木罒方
棱	木土八夂
塄	土罒方
崚	山土八夂
堎	土土八夂
里	丨乛一一丨一一
力	乛丿
理	王里
李	木子
立	亠丷一
离	亠乂凵丨乛乛丶
利	禾刂
梨	禾刂木
丽	一丨乛丶丨乛
历	厂力
礼	礻乛
厉	厂万
例	亻歹刂
莉	艹禾刂
黎	禾勹丿人氺
璃	王亠乂凵丨乛乛丶
励	厂万力
哩	口里
狸	犭里
粒	米立
隶	乛一一丨冫丿ㄟ
吏	一丨乛一丿ㄟ
栗	西木
漓	氵亠乂凵丨乛乛丶
雳	雨厂力
厘	厂里
俐	亻禾刂
笠	⺮立
沥	氵厂力
篱	⺮亠乂凵丨乛乛丶
戾	户犬
鲤	鱼里
犁	禾刂牛
砾	石乐
荔	艹力力力
砺	石厂万
郦	丽阝
藜	艹禾勹丿人氺
骊	马丽
俪	亻丽
鹂	丽鸟
蠡	乛乛豕虫虫
栎	木乐
唳	口户犬
喱	口厂里
罹	罒忄亻亠龶
痢	疒禾刂
莅	艹亻立
俚	亻里
逦	辶丽
呖	口厂力
蛎	虫厂万
猁	犭禾刂
澧	氵曲一口丷一
醴	酉曲一口丷一
娌	女里
蓠	艹亠乂凵丨乛乛丶
詈	罒亠一一口
黧	禾勹丿黑
蜊	虫禾刂
缡	纟亠乂凵丨乛乛丶
傈	亻西木
枥	木厂力
溧	氵西木
坜	土厂力
疠	疒万
粝	米厂万
嫠	未攵厂女
锂	钅里
篥	⺮西木
轹	车乐
鲡	鱼丽
疬	疒厂力
苈	艹厂力
浬	氵里
跞	⻊乐
浰	氵禾刂
鳢	鱼曲一口丷一
醨	酉亠乂凵丨乛乛丶
凓	冫西木
朸	木力
㰀	木禾勹丿人氺
珕	王力力力
𫵷	山厂力
𬍛	王乐
俩	亻两
连	辶车
脸	月人一⺍一
联	耳丷天
练	纟一乛乛丿丶
恋	亠丨丨丿丶心
怜	忄人丶龴
炼	火一乛乛丿丶
莲	艹车辶
链	钅车辶
帘	宀八巾
廉	广丷一乛一一丨丨丿ㄟ
敛	人一⺍一攵
涟	氵车辶
镰	钅广丷一乛一一丨丨丿ㄟ
琏	王车辶
濂	氵广丷一乛一一丨丨丿ㄟ
潋	氵人一⺍一攵
殓	歹人一⺍一
奁	大匚乂
裢	衤车辶
楝	木柬
裣	衤人一⺍一
鲢	鱼车辶
梿	木车辶
蠊	虫广丷一乛一一丨丨丿ㄟ
蔹	艹人一⺍一攵
瑓	王柬
𬶠	鱼柬
两	一丨乛丿丶丿丶
量	日一里
亮	亠口冖几
良	丶艮
凉	冫亠口小
梁	氵刀丿丶木
辆	车两
粮	米良
谅	讠亠口小
踉	⻊良
晾	日亠口小
粱	氵刀丿丶米
魉	鬼两
椋	木亠口小
辌	车亠口小
墚	土氵刀丿丶木
悢	忄良
俍	亻良
𫟅	纟亠口小
𬜯	艹两
聊	耳丿乛丿卩
料	米丶丶十
疗	疒了
辽	辶了
廖	广习习人丿丿丿
撩	扌大丶丿日小
寥	宀习习人丿丿丿
僚	亻大丶丿日小
缭	纟大丶丿日小
燎	火大丶丿日小
撂	扌田夂口
獠	犭大丶丿日小
潦	氵大丶丿日小
镣	钅大丶丿日小
嘹	口大丶丿日小
瞭	目大丶丿日小
寮	宀大丶丿日小
蓼	艹习习人丿丿丿
尥	尢勺
鹩	大丶丿日小鸟
嫽	女大丶丿日小
髎	骨习习人丿丿丿
钌	钅了
蹽	⻊大丶丿日小
漻	氵习习人丿丿丿
憭	忄大丶丿日小
簝	⺮大丶丿日小
橑	木大丶丿日小
𪤗	土习习人丿丿丿
列	歹刂
裂	歹刂亠𧘇
猎	犭艹一日
咧	口歹刂
烈	歹刂灬
劣	少力
冽	冫歹刂
趔	土丨一人歹刂
洌	氵歹刂
鬣	一丨一二厶丿丿丿乛乛乛囗乂乛丶丶乛丶丶乛
捩	扌户犬
埒	土丿⺍寸
躐	⻊乛乛乛囗乂乛丶丶乛丶丶乛
峛	山歹刂
脟	月丿⺍寸
䴕	歹刂鸟
𫚭	鱼乛乛乛囗乂乛丶丶乛丶丶乛
林	木木
临	丨丨丿一丶丨乛丨一
琳	王木木
淋	氵木木
邻	人丶龴阝
麟	广乛丨丨一比左匕米夕一乛丨
凛	冫亠囗口二小
拎	扌人丶龴
霖	雨木木
鳞	鱼米夕一乛丨
吝	文口
躏	⻊艹门亻亠龶
粼	米夕一乛丨乛乛
磷	石米夕一乛丨
嶙	山米夕一乛丨
蔺	艹门亻亠龶
赁	亻壬冂人
懔	忄亠囗口二小
辚	车米夕一乛丨
遴	辶米夕一乛丨
廪	广亠囗口二小
潾	氵米夕一乛丨
檩	木亠囗口二小
璘	王米夕一乛丨
啉	口木木
瞵	目米夕一乛丨
膦	月米夕一乛丨
翷	米夕一乛丨习习
箖	⺮木木
𬭸	钅米夕一乛丨
𬴊	马米夕一乛丨
令	人丶龴
灵	彐火
领	人丶龴一丿冂人
另	口力
凌	冫土八夂
玲	王人丶龴
零	雨人丶龴
龄	止人凵人丶龴
铃	钅人丶龴
陵	阝土八夂
岭	山人丶龴
菱	艹土八夂
伶	亻人丶龴
聆	耳人丶龴
翎	人丶龴习习
绫	纟土八夂
〇	乛
羚	⺶人丶龴
呤	口人丶龴
苓	艹人丶龴
泠	氵人丶龴
棂	木彐火
瓴	人丶龴瓦
酃	雨口口口阝
囹	囗人丶龴
鲮	鱼土八夂
蛉	虫人丶龴
鸰	人丶龴鸟
柃	木人丶龴
舲	舟人丶龴
澪	氵雨人丶龴
昤	日人丶龴
祾	礻土八夂
姈	女人丶龴
㥄	忄土八夂
坽	土人丶龴
流	氵亠厶丿丨乛
刘	文刂
留	丿乛丶刀田
六	亠八
柳	木丿乛丿卩
溜	氵丿乛丶刀田
琉	王亠厶丿丨乛
榴	木丿乛丶刀田
浏	氵文刂
瘤	疒丿乛丶刀田
硫	石亠厶丿丨乛
遛	辶丿乛丶刀田
陆	阝击
绺	纟夂卜口
鎏	氵亠厶丿丨乛金
馏	饣丿乛丶刀田
骝	马丿乛丶刀田
镏	钅丿乛丶刀田
旒	方丿一亠厶丿丨乛
镠	钅习习人丿丿丿
锍	钅亠厶丿丨乛
熘	火丿乛丶刀田
鹨	习习人丿丿丿鸟
飗	几乂丿乛丶刀田
瑬	氵亠厶丿丨乛玉
珋	王丿乛丿卩
罶	罒丿乛丶刀田
鹠	丿乛丶刀田鸟
疁	田习习人丿丿丿
碌	石彐氺
龙	𠂇乛丿丶
隆	阝夂一生
笼	⺮龙
拢	扌龙
胧	月龙
珑	王龙
咙	口龙
聋	龙耳
垄	龙土
窿	宀八阝夂一生
陇	阝龙
泷	氵龙
茏	艹龙
眬	目龙
栊	木龙
砻	龙石
哢	口王廾
昽	日龙
癃	疒阝夂一生
漋	氵阝夂一生
弄	王廾
𬕂	⺮工冂人
楼	木米女
搂	扌米女
漏	氵尸雨
髅	骨米女
露	雨⻊夂口
陋	阝丙乛
喽	口米女
娄	米女
篓	⺮米女
镂	钅米女
偻	亻米女
蝼	虫米女
耧	耒米女
蒌	艹米女
瘘	疒米女
嵝	山米女
溇	氵米女
䁖	目米女
剅	一口丷一刂
𦝼	月米女
𪣻	土米女
路	⻊夂口
鲁	鱼日
录	彐氺
撸	扌鱼日
卢	丨一尸
鹿	广乛丨丨一比左匕
炉	火户
芦	艹户
禄	礻彐氺
虏	虍力
璐	王⻊夂口
噜	口鱼日
戮	习习人丿丿丿戈
颅	丨一尸一丿冂人
庐	广户
漉	氵广乛丨丨一比左匕
掳	扌虍力
辘	车广乛丨丨一比左匕
赂	冂人夂口
麓	木木广乛丨丨一比左匕
卤	丨一囗乂
鹭	⻊夂口鸟
泸	氵丨一尸
潞	氵⻊夂口
橹	木鱼日
辂	车夂口
箓	⺮彐氺
胪	月丨一尸
鲈	鱼丨一尸
轳	车丨一尸
垆	土丨一尸
渌	氵彐氺
逯	辶彐氺
鸬	丨一尸鸟
甪	丿用
蕗	艹⻊夂口
舻	舟丨一尸
栌	木丨一尸
簏	⺮广乛丨丨一比左匕
菉	艹彐氺
氇	毛鱼日
僇	亻习习人丿丿丿
琭	王彐氺
镥	钅鱼日
勠	习习人丿丿丿力
稑	禾土八土
绿	纟彐氺
澛	氵鱼日
𫘧	马彐氺
𬬻	钅丨一尸
乱	千口乛
卵	丿乛丶丿乛丨丶
鸾	亠丨丨丿丶鸟
峦	亠丨丨丿丶山
挛	亠丨丨丿丶手
銮	亠丨丨丿丶金
孪	亠丨丨丿丶子
栾	亠丨丨丿丶木
滦	氵亠丨丨丿丶木
脔	亠丨丨丿丶内人
娈	亠丨丨丿丶女
论	讠人匕
伦	亻人匕
轮	车人匕
仑	人匕
沦	氵人匕
抡	扌人匕
囵	囗人匕
𫭢	土人匕
𬬭	钅人匕
罗	罒夕
洛	氵夂口
裸	衤果
逻	辶罒夕
骆	马夂口
萝	艹罒夕
螺	虫田幺小
锣	钅罒夕
啰	口罒夕
珞	王夂口
骡	马田幺小
摞	扌田幺小
雒	夂口亻亠龶
荦	艹冖牛
箩	⺮罒夕
椤	木罒夕
猡	犭罒夕
蠃	亡口月虫凡
脶	月口内
漯	氵田幺小
倮	亻果
捋	扌丿⺍寸
瘰	疒田幺小
泺	氵乐
蓏	艹瓜瓜
虑	虍心
律	彳聿
率	亠幺冫丿丶十
旅	方丿一丿乛丿ㄟ
吕	口口
缕	纟米女
侣	亻口口
驴	马户
屡	尸米女
履	尸彳丿一日夂
滤	氵虍心
褛	衤米女
铝	钅口口
闾	门口口
榈	木门口口
氯	气彐氺
膂	方丿一丿乛丿ㄟ月
稆	禾口口
葎	艹彳聿
垏	土聿
梠	木口口
略	田夂口
掠	扌亠口小
锊	钅丿⺍寸
䂮	丰刀石
圙	囗八面
吗	口马
马	乛乛一
妈	女马
麻	广木木
嘛	口广木木
骂	口口马
码	石马
玛	王马
抹	扌末
蚂	虫马
蟆	虫艹日大
犸	犭马
杩	木马
祃	礻马
摩	广木木手
买	乛丶丶大
卖	十乛丶丶大
埋	土里
脉	月永
麦	龶夂
迈	辶万
霾	雨豸里
劢	万力
唛	口龶夂
荬	艹乛丶丶大
鿏	钅龶夂
满	氵艹两
慢	忄日罒又
漫	氵日罒又
曼	日罒又
蛮	亠丨丨丿丶虫
瞒	目艹两
蔓	艹日罒又
馒	饣日罒又
幔	巾日罒又
谩	讠日罒又
鳗	鱼日罒又
缦	纟日罒又
嫚	女日罒又
墁	土日罒又
颟	艹两一丿冂人
螨	虫艹两
鞔	革⺈丨乛一丿乛
镘	钅日罒又
鬘	一丨一二厶丿丿丿日罒又
𬜬	艹门口
忙	忄亡
芒	艹亡
茫	艹氵亡
氓	亡民
莽	艹犬廾
盲	亡目
蟒	虫艹犬廾
邙	亡阝
漭	氵艹犬廾
牤	牛亡
硭	石艹亡
尨	𠂇乛丿丿丿丶
牻	牛𠂇乛丿丿丿丶
厖	厂𠂇乛丿丿丿丶
杧	木亡
毛	丿一一乛
冒	冂一一目
貌	豸白儿
猫	犭艹田
矛	龴乛丨丿
帽	巾冂一一目
贸	丿乛丶刀冂人
茂	艹戊
茅	艹龴乛丨丿
冇	𠂇冂
髦	一丨一二厶丿丿丿毛
卯	丿乛丿卩
锚	钅艹田
袤	亠龴乛丨丿𧘇
瑁	王冂一一目
懋	木龴乛丨丿木心
牦	牛毛
铆	钅丿乛丿卩
昴	日丿乛丿卩
耄	耂匕毛
蟊	龴乛丨丿虫虫
峁	山丿乛丿卩
旄	方丿一毛
楙	木龴乛丨丿木
泖	氵丿乛丿卩
瞀	龴乛丨丿攵目
茆	艹丿乛丿卩
蝥	龴乛丨丿攵虫
芼	艹毛
眊	目毛
鄚	艹日大阝
么	丿厶
没	氵几又
美	⺷大
每	丿一母
妹	女未
眉	乛丨一丿目
梅	木丿一母
媚	女乛丨一丿目
魅	鬼未
玫	王攵
枚	木攵
媒	女甘木
霉	雨丿一母
昧	日未
煤	火甘木
寐	宀爿未
嵋	山乛丨一丿目
莓	艹丿一母
湄	氵乛丨一丿目
袂	衤夬guài
楣	木乛丨一丿目
酶	酉丿一母
镁	钅⺷大
郿	乛丨一丿目阝
浼	氵⺈丨乛一丿乛
鹛	乛丨一丿目鸟
镅	钅乛丨一丿目
渼	氵⺷大
糜	广木木米
媄	女⺷大
瑂	王乛丨一丿目
门	丶丨乛
们	亻门
闷	门心
懑	氵艹两心
扪	扌门
焖	火门心
钔	钅门
呇	水口
𫞩	王艹两
梦	木木夕
猛	犭子皿
蒙	艹冖二丿乛丿丿丿ㄟ
孟	子皿
盟	日月皿
朦	月艹冖二丿乛丿丿丿ㄟ
萌	艹日月
懵	忄艹罒冖目
檬	木艹冖二丿乛丿丿丿ㄟ
蜢	虫子皿
勐	子皿力
虻	虫亡
艨	舟艹冖二丿乛丿丿丿ㄟ
锰	钅子皿
幪	巾艹冖二丿乛丿丿丿ㄟ
艋	舟子皿
蠓	虫艹冖二丿乛丿丿丿ㄟ
瞢	艹罒冖目
甍	艹罒冖瓦
獴	犭艹冖二丿乛丿丿丿ㄟ
礞	石艹冖二丿乛丿丿丿ㄟ
㠓	山艹冖二丿乛丿丿丿ㄟ
鹲	艹冖二丿乛丿丿丿ㄟ鸟
𫑡	口电阝
密	宀必山
米	丶丿木
迷	辶米
弥	弓⺈小
蜜	宀必虫
眯	目米
咪	口米
谜	讠米辶
觅	丿⺍冂见下
靡	广木木非
谧	讠必皿
祢	礻⺈小
芈	丨一丨一一一丨
麋	广乛丨丨一比左匕米
弭	弓耳
汨	氵日
猕	犭弓⺈小
幂	冖日大巾
縻	广木木幺小
蘼	艹广木木非
醚	酉米辶
祕	礻必
敉	米攵
嘧	口宀必山
蓂	艹冖日亠八
脒	月米
洣	氵米
醾	酉广木木米
面	一丿囗丨丨一一
免	⺈丨乛一丿乛
勉	⺈丨乛一丿乛力
绵	纟白巾
眠	目民
棉	木白巾
缅	纟面
冕	冂一一⺈丨乛一丿乛
腼	月面
娩	女⺈丨乛一丿乛
湎	氵面
沔	氵丏
渑	氵口电
眄	目丏
丏	一丨乛乛
勔	面力
愐	忄面
偭	亻面
𩾃	鱼⺈丨乛一丿乛
妙	女少
秒	禾少
描	扌艹田
苗	艹田
庙	广由
渺	氵目少
瞄	目艹田
淼	水水水
喵	口艹田
缈	纟目少
藐	艹豸白儿
邈	辶豸白儿
眇	目少
杪	木少
鹋	艹田鸟
缪	纟习习人丿丿丿
灭	一火
蔑	艹罒戍
乜	乛乛
咩	口羊
篾	⺮罒戍
民	乛一乛一乛
敏	丿一母攵
抿	扌民
悯	忄门文
闵	门文
珉	王民
泯	氵民
闽	门虫
皿	丨乛丨丨一
岷	山民
旻	日文
缗	纟民日
愍	民攵心
湣	氵民日
黾	口电
忞	文心
鳘	丿一母攵鱼
苠	艹民
明	日月
名	夕口
命	人一口卩
鸣	口鸟
冥	冖日亠八
铭	钅夕口
茗	艹夕口
瞑	目冖日亠八
溟	氵冖日亠八
酩	酉夕口
暝	日冖日亠八
螟	虫冖日亠八
洺	氵夕口
谬	讠习习人丿丿丿
魔	广木木鬼
莫	艹日大
默	黑犬
模	木艹日大
摸	扌艹日大
磨	广木木石
末	一一丨丿ㄟ
漠	氵艹日大
墨	黑土
麽	广木木么
陌	阝百
寞	宀艹日大
蓦	艹日大马
沫	氵末
膜	月艹日大
茉	艹末
嬷	女广木木么
蘑	艹广木木石
摹	艹日大手
馍	饣艹日大
谟	讠艹日大
嫫	女艹日大
秣	禾末
殁	歹几又
貊	豸百
靺	革末
貘	豸艹日大
镆	钅艹日大
瘼	疒艹日大
耱	耒广木木石
万	一乛丿
无	一尢
藦	艹广木木手
𬙊	纟黑土
某	甘木
谋	讠甘木
眸	目厶牛
牟	厶牛
哞	口厶牛
鍪	龴乛丨丿攵金
侔	亻厶牛
蛑	虫厶牛
目	囗一一
母	乛乛丶一丶
木	十丿ㄟ
慕	艹日大⺗
幕	艹日大巾
姆	女母
穆	禾白少丿丿
牧	牛攵
墓	艹日大土
沐	氵木
暮	艹日大日
拇	扌母
牡	牛土
亩	亠田
募	艹日大力
睦	目土八土
苜	艹目
呒	口无
钼	钅目
毪	毛厶牛
仫	亻么
𧿹	⻊母
𬭁	钅母
那	乛一一丿阝
哪	口乛一一丿阝
拿	人一口手
娜	女乛一一丿阝
纳	纟内
呐	口内
捺	扌大二小
衲	衤内
钠	钅内
肭	月内
镎	钅人一口手
乸	也母
南	十冂丷干
𦰡	艹乛一一丿阝
奶	女乃
奈	大二小
耐	而寸
乃	乛丿
鼐	乃目乛一丿丨一丨乛
氖	气乃
萘	艹大二小
艿	艹乃
柰	木二小
佴	亻耳
迺	辶西
难	又亻亠龶
男	田力
喃	口十冂丷干
楠	木十冂丷干
囡	囗女
赧	土丿丨丿丶卩又
腩	月十冂丷干
蝻	虫十冂丷干
萳	艹十冂丷干
婻	女十冂丷干
囊	一丨乛一丨冖口口一一丨丨一𧘇
囔	口一丨乛一丨冖口口一一丨丨一𧘇
馕	饣一丨乛一丨冖口口一一丨丨一𧘇
攮	扌一丨乛一丨冖口口一一丨丨一𧘇
曩	日亠口口一一丨丨一𧘇
齉	自田一丿丨一丨乛一丨冖口口一一丨丨一𧘇
脑	月亠乂凵
闹	门亠巾
恼	忄亠乂凵
挠	扌一乛丿兀
瑙	王乛乛乛丿囗乂
孬	不女子
呶	口女又
淖	氵丨一日十
猱	犭龴乛丨丿木
铙	钅一乛丿兀
垴	土亠乂凵
蛲	虫一乛丿兀
硇	石丿囗乂
臑	月雨而
峱	犭丑山
呢	口尸匕
讷	讠内
内	丨乛丿丶
馁	饣丿⺍女
嫩	女束攵
恁	亻壬心
能	厶月匕匕
你	亻⺈小
尼	尸匕
妮	女尸匕
泥	氵尸匕
逆	辶丷一乛丨丿
拟	扌乛丶人
腻	月弋二冂人
倪	亻臼儿
霓	雨臼儿
匿	匚艹𠂇口
溺	氵弓冫弓冫
昵	日尸匕
睨	目臼儿
旎	方丿一尸匕
怩	忄尸匕
猊	犭臼儿
鲵	鱼臼儿
伲	亻尸匕
坭	土尸匕
铌	钅尸匕
麑	广乛丨丨一比左匕臼儿
薿	艹匕矢龴乛丨一人
𨺙	阝臼儿
𫐐	车臼儿
𫠜	止人凵臼儿
年	丿一一丨一丨
念	人丶乛心
黏	禾人氺丨一口
拈	扌丨一口
捻	扌人丶乛心
碾	石尸艹一乛丿ㄟ
撵	扌夫夫车
蔫	艹正一乛灬
廿	艹一
辇	夫夫车
鲇	鱼丨一口
鲶	鱼人丶乛心
埝	土人丶乛心
粘	米丨一口
娘	女良
酿	酉良
鸟	乌丶
尿	尸水
袅	丿乛丶乛亠𧘇
茑	艹鸟
脲	月尸水
捏	扌日土
聂	耳又又
孽	艹丿㠯立十子
涅	氵日土
蹑	⻊耳又又
嗫	口耳又又
啮	口止人凵
臬	自木
镊	钅耳又又
镍	钅自木
蘖	艹丿㠯立十木
颞	耳又又一丿冂人
糵	艹丿㠯立十米
陧	阝日土
嵲	山自木
菍	艹人丶乛心
𫔶	门自木
您	亻⺈小心
宁	宀丁
凝	冫匕矢龴乛丨一人
狞	犭宀丁
拧	扌宀丁
柠	木宀丁
咛	口宀丁
泞	氵宀丁
佞	亻二女
甯	宀心用
苧	艹宀丁
聍	耳宀丁
牛	丿一一丨
扭	扌丑
纽	纟丑
妞	女丑
钮	钅丑
忸	忄丑
狃	犭丑
农	丶乛丿乛丿ㄟ
浓	氵农
哝	口农
侬	亻农
脓	月农
秾	禾农
𬪩	酉农
耨	耒厂二乛丿ㄟ寸
怒	女又心
努	女又力
奴	女又
弩	女又弓
驽	女又马
孥	女又子
傉	亻厂二乛丿ㄟ寸
胬	女又内人
砮	女又石
笯	⺮女又
暖	日丿⺍一𠂇又
诺	讠艹𠂇口
挪	扌乛一一丿阝
懦	忄雨而
喏	口艹𠂇口
糯	米雨而
傩	亻又亻亠龶
搦	扌弓冫弓冫
锘	钅艹𠂇口
女	乛丿一
钕	钅女
恧	而心
衄	血丑
虐	虍一乛一
疟	疒一乛一
噢	口丿冂米大
喔	口尸一厶土
欧	匚乂⺈人
偶	亻禺
呕	口匚乂
殴	匚乂几又
鸥	匚乂鸟
藕	艹耒禺
区	匚乂
怄	忄匚乂
瓯	匚乂瓦
讴	讠匚乂
沤	氵匚乂
耦	耒禺
𠙶	了凵
𬉼	火匚乂
怕	忄白
爬	爪巴
帕	巾白
啪	口扌白
趴	⻊八
琶	王王巴
葩	艹白巴
杷	木巴
筢	⺮扌巴
舥	舟巴
潖	氵王王巴
派	氵丿丿丿乛丿ㄟ
排	扌非
拍	扌白
牌	片丿丨乛一一丿十
徘	彳非
湃	氵龵一丰
俳	亻非
哌	口丿丿丿乛丿ㄟ
簰	⺮片丿丨乛一一丿十
蒎	艹氵丿丿丿乛丿ㄟ
迫	辶白
盘	舟皿
判	半刂
叛	半丿丿又
盼	目八刀
潘	氵丿米田
攀	木乂乂木大手
畔	田半
蹒	⻊艹两
磐	舟几又石
蟠	虫丿米田
槃	舟几又木
爿	乛丨一丿
泮	氵半
袢	衤半
磻	石丿米田
襻	衤木乂乂木大手
胖	月半
旁	亠丷冖方
庞	广龙
彷	彳方
乓	丘丶
螃	虫亠丷冖方
滂	氵亠丷冖方
逄	辶夂一乛丨
雱	雨方
耪	耒亠丷冖方
鳑	鱼亠丷冖方
跑	⻊勹巳
泡	氵勹巳
抛	扌九力
袍	衤勹巳
咆	口勹巳
庖	广勹巳
狍	犭勹巳
疱	疒勹巳
匏	大亏勹巳
脬	月丿⺍子
陪	阝立口
配	酉己
佩	亻几一巾
培	土立口
赔	冂人立口
裴	非亠𧘇
沛	氵一丨乛丨
呸	口丕
胚	月丕
帔	巾乛丿丨又
辔	纟车纟口
霈	雨氵一丨乛丨
旆	方丿一一丨乛丨
醅	酉立口
锫	钅立口
衃	血不
喷	口十艹冂人
盆	八刀皿
湓	氵八刀皿
朋	月月
碰	石丷亚
彭	士口丷一丿丿丿
鹏	月月鸟
捧	扌寿上ㄟ一一丨
砰	石平
蓬	艹夂丰辶
篷	⺮夂丰辶
棚	木月月
膨	月士口丷一丿丿丿
澎	氵士口丷一丿丿丿
怦	忄平
嘭	口士口丷一丿丿丿
烹	亠口了灬
抨	扌平
芃	艹凡
硼	石月月
蟛	虫士口丷一丿丿丿
堋	土月月
椪	木丷亚
弸	弓月月
淜	氵月月
皮	乛丿丨又
批	扌比左匕
屁	尸比左匕
疲	疒乛丿丨又
匹	匚儿
劈	尸口立十刀
披	扌乛丿丨又
脾	月丿丨乛一一丿十
啤	口丿丨乛一一丿十
僻	亻尸口立十
霹	雨尸口立十
痞	疒不口
譬	尸口立十亠一一口
噼	口尸口立十
琵	王王比左匕
癖	疒尸口立十
媲	女丿囗乂比左匕
丕	不一
毗	田比左匕
坯	土丕
纰	纟比左匕
睥	目丿丨乛一一丿十
邳	丕阝
砒	石比左匕
貔	豸丿囗乂比左匕
枇	木比左匕
罴	罒土厶灬
圮	土己
鼙	士口丷一十又丿丨乛一一丿十
蚍	虫比左匕
铍	钅乛丿丨又
郫	丿丨乛一一丿十阝
仳	亻比左匕
伾	亻丕
蜱	虫丿丨乛一一丿十
埤	土丿丨乛一一丿十
嚭	士口丷一口不口
陴	阝丿丨乛一一丿十
淠	氵田一丿丨
甓	尸口立十瓦
狉	犭丕
澼	氵尸口立十
鲏	鱼乛丿丨又
䴙	尸口立十鸟
苉	艹匚儿
𬳵	马丕
片	丿丨一乛
偏	亻户冂艹
骗	马户冂艹
篇	⺮户冂艹
翩	户冂艹习习
骈	马丷开
蹁	⻊户冂艹
谝	讠户冂艹
胼	月丷开
犏	牛户冂艹
楩	木亻更
㛹	女亻更
𡎚	土户冂艹
飘	西二小几乂
漂	氵西二小
票	西二小
瞟	目西二小
嫖	女西二小
瓢	西二小瓜
缥	纟西二小
剽	西二小刂
朴	木卜
殍	歹丿⺍子
嘌	口西二小
螵	虫西二小
蔈	艹西二小
薸	艹氵西二小
撇	扌丶丿丨乛丨丿丶攵
瞥	丶丿丨乛丨丿丶攵目
苤	艹丕
氕	气丿
𬭯	钅丶丿丨乛丨丿丶攵
品	口口口
拼	扌丷开
贫	八刀冂人
频	止丨丿丿一丿冂人
聘	耳由一乛
嫔	女宀丘八
颦	止丨丿丿一丿冂人丿丨乛一一丿十
姘	女丷开
牝	牛匕
玭	王比左匕
𬞟	艹止丨丿丿一丿冂人
平	一丶丿十
凭	亻壬几
评	讠平
瓶	丷开瓦
萍	艹氵平
苹	艹平
坪	土平
乒	丘丿
娉	女由一乛
枰	木平
鲆	鱼平
俜	亻由一乛
泙	氵平
洴	氵丷开
帡	巾丷开
荓	艹丷开
蚲	虫平
涄	氵由一乛
玶	王平
破	石乛丿丨又
婆	氵乛丿丨又女
颇	乛丿丨又一丿冂人
坡	土乛丿丨又
魄	白鬼
泼	氵乛丿又丶
珀	王白
叵	匚口
鄱	丿米田阝
粕	米白
笸	⺮匚口
皤	白丿米田
钋	钅卜
钷	钅匚口
桲	木十冖子
䥽	钅乛丿又丶
酦	酉乛丿又丶
剖	立口刂
抔	扌不
裒	亠臼𧘇
掊	扌立口
普	丷亚日
扑	扌卜
铺	钅甫
仆	亻卜
谱	讠丷亚日
葡	艹勹甫
菩	艹立口
噗	口业⺶ㄟ
浦	氵甫
蒲	艹氵甫
濮	氵亻业⺶ㄟ
璞	王业⺶ㄟ
圃	囗甫
溥	氵甫寸
匍	勹甫
莆	艹甫
蹼	⻊业⺶ㄟ
氆	毛丷亚日
潽	氵丷亚日
酺	酉甫
镨	钅丷亚日
镤	钅业⺶ㄟ
蒱	艹扌甫
墣	土业⺶ㄟ
穙	禾业⺶ㄟ
起	土丨一人己
气	丿一一乛
其	其上八
七	一乛
器	口口犬口口
骑	马大丁口
齐	文丿丨
弃	亠厶廾
妻	一乛一一丨女
企	人止
启	户口
旗	方丿一其上八
欺	其上八⺈人
岂	山己
汽	氵气
棋	木其上八
琪	王其上八
泣	氵立
凄	冫一乛一一丨女
漆	氵木人氺
戚	戊上小
契	丰刀大
乞	丿一乛
祈	礻斤
麒	广乛丨丨一比左匕其上八
歧	止十又
琦	王大丁口
祁	礻阝
绮	纟大丁口
栖	木西
炁	一乛丿乛灬
淇	氵其上八
崎	山大丁口
砌	石七刀
蹊	⻊丿⺍幺大
祺	礻其上八
迄	辶乞
杞	木己
岐	山十又
脐	月文丿丨
颀	斤一丿冂人
沏	氵七刀
跂	⻊十又
憩	千口自心
萋	艹一乛一一丨女
嘁	口戊上小
耆	耂匕日
芑	艹己
蜞	虫其上八
讫	讠乞
祇	礻氏
鳍	鱼耂匕日
亓	二丿丨
葺	艹口耳
柒	氵七木
綦	其上八幺小
蕲	艹丷丨乛一一一丨斤
畦	田土土
芪	艹氏
圻	土斤
萁	艹其上八
骐	马其上八
欹	大丁口⺈人
碛	石龶冂人
汔	氵乞
锜	钅大丁口
槭	木戊上小
蛴	虫文丿丨
屺	山己
玘	王己
桤	木山己
埼	土大丁口
棨	户攵木
郪	一乛一一丨女阝
磜	石丿乛丶丶二小
鲯	鱼其上八
愭	忄耂匕日
碶	石丰刀大
俟	亻厶矢
婍	女大丁口
洓	氵一丨乛丨丿ㄟ
䓫	艹大丁口
𨙸	十又阝
𬨂	车氏
恰	忄人一口
拤	扌上卜
掐	扌⺈臼
洽	氵人一口
葜	艹丰刀大
袷	衤人一口
髂	骨宀夂口
前	丷一月刂
钱	钅戋
千	丿十
潜	氵夫夫日
牵	大冖牛
倩	亻龶月
浅	氵戋
签	⺮人一⺍一
歉	丷一乛一一丨丨丿ㄟ⺈人
欠	⺈人
乾	十日十乞
谦	讠丷一乛一一丨丨丿ㄟ
迁	辶千
遣	辶中一㠯
茜	艹西
芊	艹千
嵌	山甘⺈人
虔	虍文
铅	钅几口
谴	讠中一㠯辶
钳	钅甘
黔	黑人丶乛
堑	车斤土
骞	宀一一丨丨一八马
佥	人一⺍一
仟	亻千
缱	纟中一㠯辶
纤	纟千
阡	阝千
钎	钅千
钤	钅人丶乛
掮	扌户月
芡	艹⺈人
荨	艹彐寸
扦	扌千
愆	彳氵亍心
悭	忄丨丨又土
搴	宀一一丨丨一八手
慊	忄丷一乛一一丨丨丿ㄟ
褰	宀一一丨丨一八亠𧘇
汧	氵开
肷	月⺈人
蒨	艹亻龶月
靬	革干
椠	车斤木
杄	木千
鹐	⺈臼鸟
岍	山开
圲	土千
伣	亻冂见下
墘	土十日十乞
磏	石丷一乛一一丨丨丿ㄟ
𬘬	纟龶月
枪	木人乛乛
墙	土十丶丿一囗口
抢	扌人乛乛
腔	月宀八工
呛	口人乛乛
跄	⻊人乛乛
蔷	艹十丶丿一囗口
锵	钅冫丨夕寸
羌	⺶乛
戕	爿戈
戗	人乛乛戈
襁	衤弓口虫
嫱	女十丶丿一囗口
樯	木十丶丿一囗口
镪	钅弓口虫
炝	火人乛乛
羟	⺶乛丶工
蜣	虫羌
玱	王人乛乛
锖	钅龶月
蔃	艹弓口虫
巧	工一乛
悄	忄⺌月
瞧	目亻亠龶灬
敲	亠口冂口丨一又
桥	木夭丿丨
乔	夭丿丨
俏	亻⺌月
翘	一乛丿兀习习
窍	宀八工一乛
鞘	革⺌月
憔	忄亻亠龶灬
峭	山⺌月
跷	⻊一乛丿兀
侨	亻夭丿丨
樵	木亻亠龶灬
撬	扌毛毛毛
锹	钅禾火
谯	讠亻亠龶灬
橇	木毛毛毛
诮	讠⺌月
荞	艹夭丿丨
愀	忄禾火
劁	亻亠龶灬刂
硗	石一乛丿兀
鞒	革夭丿丨
硚	石夭丿丨
缲	纟口口口木
雀	少丨亠龶
且	丨乛一一一
切	七刀
窃	宀八七刀
怯	忄土厶
妾	立女
惬	忄匚夹
锲	钅丰刀大
挈	丰刀手
箧	⺮匚夹
郄	乂𠂇厶阝
亲	立朩
秦	寿上ㄟ禾
琴	王王人丶乛
侵	亻彐冖又
勤	廿丨乛一一一丨一力
寝	宀冫丨彐冖又
擒	扌人亠乂凵丨乛乛丶
钦	钅⺈人
芹	艹斤
沁	氵心
禽	人亠乂凵丨乛乛丶
覃	西日十
噙	口人亠乂凵丨乛乛丶
衾	人丶乛亠𧘇
揿	扌钅⺈人
芩	艹人丶乛
溱	氵寿上ㄟ禾
吣	口心
嗪	口寿上ㄟ禾
锓	钅彐冖又
檎	木人亠乂凵丨乛乛丶
骎	马亻彐冖又
慬	忄廿丨乛一一一丨一
嵚	山钅⺈人
请	讠龶月
轻	车乛丶工
清	氵龶月
青	龶月
情	忄龶月
庆	广大
晴	日龶月
倾	亻比左一丿冂人
卿	丿乛丿即左卩
擎	艹勹口攵手
顷	比左一丿冂人
蜻	虫龶月
箐	⺮龶月
氢	气乛丶工
罄	士乛丨一丿几又缶
磬	士乛丨一丿几又石
綮	户攵幺小
氰	气龶月
黥	黑亠口小
檠	艹勹口攵木
鲭	鱼龶月
苘	艹冂口
圊	囗龶月
碃	石龶月
庼	广比左一丿冂人
勍	亠口小力
穷	宀八力
琼	王亠口小
穹	宀八弓
茕	艹冖乛十
邛	工阝
筇	⺮工阝
蛩	工凡虫
銎	工凡金
䓖	艹宀八力
求	一丨冫丿ㄟ丶
球	王求
秋	禾火
丘	丿丨一丨一
邱	丘阝
囚	囗人
裘	求亠𧘇
酋	丷酉
虬	虫乛
糗	米自犬
鳅	鱼禾火
蚯	虫丘
俅	亻求
泅	氵囗人
遒	辶丷酉
逑	辶求
楸	木禾火
犰	犭九
萩	艹禾火
蝤	虫丷酉
璆	王习习人丿丿丿
巯	乛丶工亠厶丿丨乛
赇	冂人求
鹙	禾火鸟
鞧	革丷酉
鼽	自田一丿丨九
訄	九亠一一口
𨱇	钅求
去	土厶
取	耳又
趣	土丨一人耳又
曲	丨乛一丨丨一
屈	尸出
躯	身匚乂
驱	马匚乂
娶	耳又女
趋	土丨一人⺈彐
渠	氵巨木
觑	虍业冂见下
瞿	目目亻亠龶
岖	山匚乂
蛐	虫曲
蛆	虫且
衢	彳目目亻亠龶亍
祛	礻土厶
黢	黑厶八夂
癯	疒目目亻亠龶
阒	门目犬
龋	止人凵禹
蕖	艹氵巨木
蘧	艹虍豕辶
朐	月勹口
璩	王虍豕
劬	勹口力
磲	石氵巨木
诎	讠出
蠼	虫目目亻亠龶又
袪	衤土厶
氍	目目亻亠龶毛
鸲	勹口鸟
麹	龶夂勹米
胠	月土厶
灈	氵目目亻亠龶
鼩	臼乛丶丶乛丶丶乛勹口
竘	立勹口
戌	戊一
㭕	木土厶
䓛	艹尸出
坥	土且
𪨰	山曲
𫭟	土匚乂
全	人王
权	木又
拳	龹手
劝	又力
泉	白水
犬	大丶
券	龹刀
蜷	虫龹乛乛
痊	疒人王
诠	讠人王
荃	艹人王
颧	艹口口亻亠龶一丿冂人
绻	纟龹乛乛
铨	钅人王
筌	⺮人王
鬈	一丨一二厶丿丿丿龹乛乛
醛	酉艹人王
悛	忄厶八夂
佺	亻人王
畎	田犬
棬	木龹乛乛
鳈	鱼白水
辁	车人王
婘	女龹乛乛
瑔	王白水
𨟠	目目亻亠龶阝
却	土厶卩
确	石⺈用
缺	缶夬
瘸	疒力口内人
鹊	艹一日鸟
阙	门丷一乛丨丿⺈人
阕	门乛丶丿丿ㄟ天
榷	木丶乛丿丨亠龶
炔	火夬guài
悫	士冖几心
碏	石艹一日
埆	土⺈用
𬒈	⺍冖石
群	尹口羊
裙	衤尹口
逡	辶厶八夂
囷	囗禾
然	丿乛丶丶犬灬
染	氵九木
燃	火丿乛丶丶犬灬
冉	丨乛丨一一
髯	一丨一二厶丿丿丿冉
苒	艹冉
蚺	虫冉
䎃	冉习习
让	讠上
嚷	口亠口口一一丨丨一𧘇
壤	土亠口口一一丨丨一𧘇
攘	扌亠口口一一丨丨一𧘇
瓤	亠口口一一丨丨一𧘇瓜
禳	礻亠口口一一丨丨一𧘇
穰	禾亠口口一一丨丨一𧘇
瀼	氵亠口口一一丨丨一𧘇
蘘	艹亠口口一一丨丨一𧘇
儴	亻亠口口一一丨丨一𧘇
绕	纟一乛丿兀
扰	扌尤
饶	饣一乛丿兀
娆	女一乛丿兀
桡	木一乛丿兀
荛	艹一乛丿兀
热	扌丸灬
惹	艹𠂇口心
人	丿ㄟ
任	亻壬
认	讠人
忍	刃心
仁	亻二
刃	刀丶
韧	韦刃
壬	丿士
饪	饣壬
仞	亻刃
纫	纟刃
稔	禾人丶乛心
荏	艹亻壬
妊	女壬
衽	衤壬
轫	车刃
纴	纟壬
讱	讠刃
葚	艹其上八乛
仍	亻乃
扔	扌乃
日	囗一
驲	马日
容	宀八人口
荣	艹冖木
融	一口冂丷一丨虫
蓉	艹宀八人口
绒	纟戈𠂇
溶	氵宀八人口
戎	戈𠂇
榕	木宀八人口
茸	艹耳
熔	火宀八人口
冗	冖几
嵘	山艹冖木
镕	钅宀八人口
蝾	虫艹冖木
狨	犭戈𠂇
瑢	王宀八人口
肉	内人
柔	龴乛丨丿木
揉	扌龴乛丨丿木
蹂	⻊龴乛丨丿木
糅	米龴乛丨丿木
鞣	革龴乛丨丿木
𫐓	车龴乛丨丿木
如	女口
入	丿ㄟ
辱	厂二乛丿ㄟ寸
乳	丿⺍子乛
儒	亻雨而
茹	艹女口
汝	氵女
蠕	虫雨而
孺	子雨而
褥	衤厂二乛丿ㄟ寸
嚅	口雨而
濡	氵雨而
缛	纟厂二乛丿ㄟ寸
襦	衤雨而
溽	氵厂二乛丿ㄟ寸
蓐	艹厂二乛丿ㄟ寸
洳	氵女口
薷	艹雨而
颥	雨而一丿冂人
嬬	女雨而
铷	钅女口
软	车⺈人
阮	阝二儿
堧	土而大
瓀	王雨而
媆	女而大
瑞	王山而
锐	钅丷口儿
蕊	艹心心心
睿	丨一冖一八人目
芮	艹内
蚋	虫内
蕤	艹豕生
枘	木内
汭	氵内
润	氵门王
闰	门王
若	艹𠂇口
弱	弓冫弓冫
偌	亻艹𠂇口
箬	⺮艹𠂇口
婼	女艹𠂇口
爇	艹土八土丸灬
蒻	艹弓冫弓冫
鄀	艹𠂇口阝
萨	艹阝产
撒	扌艹一月攵
洒	氵西
飒	立几乂
仨	亻三
卅	一丿丨丨
靸	革及
挲	氵少手
潵	氵艹一月攵
脎	月乂朩
赛	宀一一丨丨一八冂人
塞	宀一一丨丨一八土
腮	月田心
噻	口宀一一丨丨一八丶丶土
鳃	鱼田心
三	一二
散	艹一月攵
伞	人丶丿十
叁	厶大三
馓	饣艹一月攵
毵	厶大丿丿丿毛
糁	米厶大丿丿丿
丧	十丶丿一乛丿ㄟ
桑	又又又木
嗓	口又又又木
搡	扌又又又木
颡	又又又木一丿冂人
磉	石又又又木
扫	扌彐
骚	马叉虫
嫂	女丿丨一乛一一丨又
搔	扌叉虫
臊	月口口口木
瘙	疒叉虫
缫	纟乛乛乛果
埽	土彐冖巾
溞	氵叉虫
色	⺈巴
瑟	王王必
涩	氵刃止
啬	十丶丿一囗口
穑	禾十丶丿一囗口
铯	钅⺈巴
璱	王王王必
森	木木木
僧	亻丷囗⺌日
啥	口人干口
傻	亻丿囗乂八夂
杀	乂朩
莎	艹氵少
煞	⺈彐攵灬
纱	纟少
沙	氵少
厦	厂一自夂
霎	雨立女
砂	石少
鲨	氵少鱼
裟	氵少亠𧘇
铩	钅乂朩
嗄	口一自夂
歃	千臼⺈人
痧	疒氵少
唼	口立女
杉	木丿丿丿
晒	日西
筛	⺮丨丿一巾
山	丨凵
删	册刂
闪	门人
善	羊丶丿一口
扇	户习习
衫	衤丿丿丿
珊	王册
擅	扌亠囗口日一
姗	女册
讪	讠山
陕	阝夹
煽	火户习习
膳	月羊丶丿一口
跚	⻊册
潸	氵木木月
缮	纟羊丶丿一口
汕	氵山
赡	冂人⺈厂八亠一一口
鳝	鱼羊丶丿一口
舢	舟山
苫	艹丨一口
嬗	女亠囗口日一
鄯	羊丶丿一口阝
骟	马户习习
蟮	虫羊丶丿一口
墡	土羊丶丿一口
剡	火火刂
疝	疒山
芟	艹几又
埏	土丿丨一乛廴
钐	钅丿丿丿
嶦	山⺈厂八亠一一口
晱	日火火
栅	木册
烻	火丿丨一乛廴
𫮃	土丷丨乛一一一丨
上	丨一一
伤	亻丿一力
商	亠丷冂八口
尚	⺌冂口
赏	⺌冖口冂人
晌	日丿冂口
殇	歹丿一乛丿丿
觞	⺈用丿一乛丿丿
熵	火亠丷冂八口
墒	土亠丷冂八口
绱	纟⺌冂口
垧	土丿冂口
少	小丿
烧	火一乛丿兀
稍	禾⺌月
绍	纟刀口
哨	口⺌月
邵	刀口阝
勺	勹丶
梢	木⺌月
韶	立日刀口
劭	刀口力
捎	扌⺌月
芍	艹勺
苕	艹刀口
艄	舟⺌月
筲	⺮⺌月
潲	氵禾⺌月
蛸	虫⺌月
睄	目⺌月
召	刀口
柖	木刀口
玿	王刀口
社	礻土
射	身寸
设	讠几又
舍	人干口
蛇	虫宀匕
舌	千口
涉	氵止丨丿丿
摄	扌耳又又
奢	大耂日
慑	忄耳又又
赦	土丿丨丿丶攵
折	扌斤
佘	人二小
麝	广乛丨丨一比左匕身寸
赊	冂人人二小
畲	人二小田
猞	犭人干口
歙	人一口习习⺈人
滠	氵耳又又
厍	厂车
拾	扌人一口
𪨶	山大车
谁	讠亻亠龶
神	礻申
深	氵冖八木
身	丿丨乛一一一丿
甚	其上八乛
什	亻十
伸	亻申
沈	氵丶乛丿乛
审	宀申
申	丨乛一一丨
慎	忄十具上八
呻	口申
渗	氵厶大丿丿丿
婶	女宀申
绅	纟申
肾	丨丨又月
莘	艹立十
珅	王申
蜃	厂二乛丿ㄟ虫
哂	口西
娠	女厂二乛丿ㄟ
燊	火火火木
瘆	疒厶大丿丿丿
椹	木其上八乛
砷	石申
诜	讠⺧儿
甡	生生
谂	讠人丶乛心
矧	矢弓丨
胂	月申
侁	亻⺧儿
瞫	目西日十
鲹	鱼厶大丿丿丿
屾	山山
𬬹	钅申
𬳽	马⺧儿
生	丿龶
声	士乛丨一丿
圣	又土
胜	月生
升	丿廾
省	少目
剩	千丨一一匕丿ㄟ刂
绳	纟口电
牲	牛生
笙	⺮生
甥	生田力
昇	日升
嵊	山千丨一一匕丿ㄟ
眚	生目
陞	阝升土
是	日一丨一人
时	日寸
事	一丨乛一乛一一丨
实	宀丶丶大
十	一丨
师	丨丿一巾
使	亻吏
屎	尸米
世	一丨丨一乛
始	女厶口
失	丿夫
士	十一
湿	氵日业
识	讠口八
视	礻冂见下
势	扌丸力
市	亠巾
室	宀一厶土
式	弋工
示	二小
试	讠弋工
史	丨乛一丿ㄟ
食	人良
施	方丿一也
适	辶千口
释	丿米又一一丨
诗	讠土寸
尸	乛一丿
氏	丿乛一乛
侍	亻土寸
饰	饣丿一巾
誓	扌斤亠一一口
驶	马史
逝	辶扌斤
狮	犭丨丿一巾
噬	口⺮工人人
仕	亻士
矢	丿天
拭	扌弋工
嗜	口耂匕日
似	亻乛丶人
蚀	饣虫
恃	忄土寸
柿	木亠巾
弑	乂朩弋工
轼	车弋工
虱	乛丿虫
谥	讠丷一八皿
舐	千口氏
媞	女日一丨一人
豕	一丿乛丿丿丿ㄟ
莳	艹日寸
筮	⺮工人人
蓍	艹耂匕日
螫	土丿丨丿丶攵虫
炻	火石
鲥	鱼日寸
奭	大百百
湜	氵日一丨一人
埘	土日寸
酾	酉丽
祏	礻石
栻	木弋工
贳	世冂人
铈	钅亠巾
鲺	鱼乛丿虫
鼫	臼乛丶丶乛丶丶乛石
邿	土寸阝
鸤	尸鸟
嘘	口虍业
峙	山土寸
殖	歹十具上
浉	氵丨丿一巾
襫	衤大百百
䏡	月二小
䴓	一巾鸟
𫚕	鱼丨丿一巾
𬤊	讠日一丨一人
手	丿一一丨
受	丿⺍冖又
收	乛丨攵
首	丷一自
守	宀寸
熟	亠口子丸灬
兽	丷田一口
授	扌丿⺍冖又
瘦	疒丿丨一乛一一丨又
售	亻亠龶口
寿	寿上寸
狩	犭宀寸
绶	纟丿⺍冖又
艏	舟丷一自
书	乛乛丨丶
数	米女攵
术	木丶
树	木又寸
属	尸禹
叔	上小又
束	一丨乛一丨丿ㄟ
舒	人干口龴乛丨
输	车人一月刂
述	辶术
殊	歹朱
鼠	臼乛丶丶乛丶丶乛
疏	乛止亠厶丿丨乛
淑	氵上小又
竖	丨丨又立
署	罒耂日
墅	里龴乛丨土
梳	木亠厶丿丨乛
蜀	罒勹虫
恕	女口心
倏	亻丨夂犬
暑	日耂日
庶	广廿灬
漱	氵束⺈人
赎	冂人十乛丶丶大
姝	女朱
枢	木匚乂
蔬	艹乛止亠厶丿丨乛
薯	艹罒耂日
曙	日罒耂日
抒	扌龴乛丨
孰	亠口子丸
戍	戊丶
塾	亠口子丸土
纾	纟龴乛丨
澍	氵士口丷一寸
黍	禾人氺
沭	氵术
秫	禾术
殳	几又
菽	艹上小又
腧	月人一月刂
毹	人一月刂毛
摅	扌虍心
婌	女上小又
鄃	人一月刂阝
隃	阝人一月刂
陎	阝朱
𬬸	钅术
刷	尸巾刂
耍	而女
唰	口尸巾刂
帅	丨丿巾
摔	扌亠幺冫丿丶十
甩	冂一一乛
涮	亠丨乛一一𧘇
闩	门一
腨	月山而
双	又又
爽	大乂乂乂乂
霜	雨木目
孀	女雨木目
鹴	雨木目鸟
骦	马雨木目
礵	石雨木目
水	丨乛丿ㄟ
睡	目垂
税	禾丷口儿
帨	巾丷口儿
说	讠丷口儿
顺	川一丿冂人
瞬	目丿⺍冖夕一乛丨
吮	口厶儿
舜	丿⺍冖夕一乛丨
楯	木丿丿十目
烁	火乐
硕	石一丿冂人
朔	丷一乛丨丿月
铄	钅乐
槊	丷一乛丨丿月木
搠	扌丷一乛丨丿月
妁	女勺
蒴	艹丷一乛丨丿月
死	歹匕
四	囗儿
思	田心
斯	其上八斤
司	乛一口
丝	乛乛乛乛一
私	禾厶
寺	土寸
撕	扌其上八斤
肆	一丨一二厶聿
嘶	口其上八斤
厮	厂其上八斤
祀	礻巳
嗣	口冂艹乛一口
饲	饣乛一口
巳	乛一乛
泗	氵囗儿
咝	口丝
姒	女乛丶人
汜	氵巳
驷	马囗儿
鸶	丝鸟
兕	凹儿
涘	氵厶矢
缌	纟田心
蛳	虫丨丿一巾
澌	氵其上八斤
锶	钅田心
笥	⺮乛一口
耜	耒㠯
飔	几乂田心
凘	冫其上八斤
虒	丿丿虍几
㟃	山乛一口
楒	木田心
送	辶丷天
松	木八厶
宋	宀木
耸	人人耳
诵	讠龴用
怂	人人心
𪨊	尸人人
颂	八厶一丿冂人
嵩	山亠口冂口
悚	忄束
讼	讠八厶
忪	忄八厶
淞	氵木八厶
崧	山木八厶
竦	立束
凇	冫木八厶
菘	艹木八厶
娀	女戈𠂇
㧐	扌又又
搜	扌丿丨一乛一一丨又
艘	舟丿丨一乛一一丨又
嗽	口束⺈人
嗖	口丿丨一乛一一丨又
叟	丿丨一乛一一丨又
飕	几乂丿丨一乛一一丨又
擞	扌米女攵
馊	饣丿丨一乛一一丨又
薮	艹米女攵
廋	广丿丨一乛一一丨又
溲	氵丿丨一乛一一丨又
嗾	口方丿一矢
锼	钅丿丨一乛一一丨又
瞍	目丿丨一乛一一丨又
蒐	艹鬼
螋	虫丿丨一乛一一丨又
诉	讠斥
速	辶束
苏	艹办
素	龶幺小
宿	宀亻百
俗	亻八人口
肃	乛一一丨丿丨丿丶
塑	丷一乛丨丿月土
酥	酉禾
簌	⺮束⺈人
粟	西米
稣	鱼禾
溯	氵丷一乛丨丿月
愫	忄龶幺小
夙	几歹
谡	讠田八夂
窣	宀八亠人人十
蔌	艹束⺈人
涑	氵束
嗉	口龶幺小
僳	亻西米
觫	⺈用束
骕	马肃
甦	更生
鹔	肃鸟
傃	亻龶幺小
蹜	⻊宀亻百
缩	纟宀亻百
𫗧	饣束
算	⺮目廾
酸	酉厶八夂
蒜	艹二小二小
狻	犭厶八夂
虽	口虫
随	阝𠂇月辶
岁	山夕
碎	石亠人人十
遂	辶丷豕
隋	阝𠂇工月
髓	骨𠂇工月辶
祟	出二小
穗	禾一丨乛一一丨一丶心
邃	辶宀八丷豕
隧	阝丷豕辶
绥	纟丿⺍女
燧	火丷豕辶
睢	目亻亠龶
眭	目土土
荽	艹丿⺍女
谇	讠亠人人十
濉	氵目亻亠龶
穟	禾丷豕辶
璲	王丷豕辶
襚	衤丷豕辶
旞	方丿一丷豕辶
𫟦	车丷豕辶
𬭼	钅丷豕辶
孙	子小
损	扌口冂人
笋	⺮尹
隼	亻亠龶十
荪	艹子小
狲	犭子小
榫	木亻亠龶十
飧	夕人良
所	丿丿乛一斤
索	十冖幺小
锁	钅⺌冂人
嗦	口十冖幺小
梭	木厶八夂
琐	王⺌冂人
唆	口厶八夂
娑	氵少女
蓑	艹亠丨乛一一𧘇
桫	木氵少
唢	口⺌冂人
睃	目厶八夂
嗍	口丷一乛丨丿月
羧	⺶厶八夂
溹	氵十冖幺小
他	亻也
她	女也
它	宀匕
塔	土艹人一口
踏	⻊水日
拓	扌石
塌	土日习习
榻	木日习习
蹋	⻊日习习
遢	辶日习习
挞	扌大辶
趿	⻊及
獭	犭束⺈冂人
祂	礻也
闼	门大辶
鳎	鱼日习习
铊	钅宀匕
溻	氵日习习
阘	门日习习
褟	衤日习习
鞳	革艹人一口
太	大丶
台	厶口
态	太心
抬	扌厶口
泰	寿上ㄟ氺
胎	月厶口
汰	氵太
苔	艹厶口
跆	⻊厶口
钛	钅太
邰	厶口阝
薹	艹士口冖一厶土
肽	月太
炱	厶口火
酞	酉太
鲐	鱼厶口
谈	讠火火
叹	口又
探	扌冖八木
坦	土日一
贪	人丶乛冂人
坛	土二厶
摊	扌又亻亠龶
滩	氵又亻亠龶
谭	讠西日十
潭	氵西日十
瘫	疒又亻亠龶
毯	毛火火
炭	山𠂇火
忐	上心
檀	木亠囗口日一
痰	疒火火
碳	石山𠂇火
袒	衤日一
昙	日二厶
坍	土丹
郯	火火阝
倓	亻火火
锬	钅火火
钽	钅日一
璮	王亠囗口日一
惔	忄火火
菼	艹火火
榃	木木田
磹	石西日十
堂	⺌冖口土
唐	广乛一一丨口
躺	身⺌冂口
汤	氵乛丿丿
趟	土丨一人⺌冂口
糖	米广乛一一丨口
烫	氵乛丿丿火
膛	月⺌冖口土
倘	亻⺌冂口
淌	氵⺌冂口
棠	⺌冖口木
塘	土广乛一一丨口
搪	扌广乛一一丨口
螳	虫⺌冖口土
傥	亻⺌冖口儿
瑭	王广乛一一丨口
镗	钅⺌冖口土
帑	女又巾
樘	木⺌冖口土
蹚	⻊⺌冖口土
嘡	口⺌冖口土
溏	氵广乛一一丨口
螗	虫广乛一一丨口
羰	⺶山𠂇火
镋	钅⺌冖口儿
耥	耒⺌冂口
埫	土⺌冂口
铴	钅氵乛丿丿
䣘	⺌冖口土阝
鄌	广乛一一丨口阝
逃	辶儿冫丿丶
讨	讠寸
套	大一丨一二厶
桃	木儿冫丿丶
涛	氵寿上寸
掏	扌勹缶
陶	阝勹缶
滔	氵丿⺍臼
萄	艹勹缶
淘	氵勹缶
韬	韦丿⺍臼
焘	寿上寸灬
啕	口勹缶
饕	口一乛虍几人良
绦	纟夂朩
洮	氵儿冫丿丶
梼	木寿上寸
绹	纟勹缶
弢	弓乛丨丨又
鼗	儿冫丿丶士口丷一十又
慆	忄丿⺍臼
𫘦	马勹缶
特	牛土寸
忑	下心
慝	匚艹𠂇口心
铽	钅弋心
忒	弋心
疼	疒夂丶丶
腾	月龹马
藤	艹月龹氺
滕	月龹氺
誊	龹亠一一口
螣	月龹虫
縢	月龹幺小
熥	火龴用辶
䲢	月龹鱼
题	日一丨一人一丿冂人
体	亻本
替	夫夫日
踢	⻊日勿
梯	木丷乛一乛丨丿
蹄	⻊亠丷冖巾
惕	忄日勿
涕	氵丷乛一乛丨丿
啼	口亠丷冖巾
剔	日勿刂
屉	尸世
剃	丷乛一乛丨丿刂
嚏	口十冖田乛丨一人
倜	亻冂土口
缇	纟日一丨一人
逖	辶犭火
荑	艹夷
醍	酉日一丨一人
悌	忄丷乛一乛丨丿
鹈	丷乛一乛丨丿鸟
绨	纟丷乛一乛丨丿
锑	钅丷乛一乛丨丿
裼	衤日勿
趯	土丨一人习习亻亠龶
遆	辶亠丷冖巾
鳀	鱼日一丨一人
擿	扌亠丷冂十口辶
䏲	月丷乛一乛丨丿
䴘	丿丿虍几鸟
瑅	王日一丨一人
𫘨	马日一丨一人
天	一大
田	囗十
甜	千口甘
添	氵天⺗
填	土十具上八
舔	千口天⺗
恬	忄千口
腆	月丨乛一丨丨一八
阗	门十具上八
殄	歹人丿丿丿
忝	天⺗
湉	氵忄千口
畋	田攵
瑱	王十具上八
掭	扌天⺗
盷	目勹冫
淟	氵丨乛一丨丨一八
晪	日丨乛一丨丨一八
沺	氵田
黇	艹一由八丨一口
条	夂朩
跳	⻊儿冫丿丶
挑	扌儿冫丿丶
眺	目儿冫丿丶
迢	辶刀口
窕	宀八儿冫丿丶
佻	亻儿冫丿丶
笤	⺮刀口
祧	礻儿冫丿丶
髫	一丨一二厶丿丿丿刀口
粜	出米
龆	止人凵刀口
蜩	虫冂土口
鲦	鱼夂朩
朓	月儿冫丿丶
嬥	女习习亻亠龶
铁	钅失
贴	冂人丨一口
帖	巾丨一口
餮	歹人丿丿丿人良
萜	艹巾丨一口
听	口斤
停	亻亠口冖丁
厅	厂丁
挺	扌壬廴
庭	广壬廴
廷	廴壬
婷	女亠口冖丁
亭	亠口冖丁
艇	舟壬廴
霆	雨壬廴
汀	氵丁
蜓	虫壬廴
铤	钅壬廴
葶	艹亠口冖丁
莛	艹壬廴
珽	王壬廴
梃	木壬廴
烃	火乛丶工
渟	氵亠口冖丁
颋	壬廴一丿冂人
桯	木口王
侹	亻壬廴
䗴	虫⺮壬廴
圢	土丁
烶	火壬廴
𬘩	纟壬廴
同	冂一口
通	辶龴用
痛	疒龴用
统	纟亠厶儿
童	立里
铜	钅冂一口
筒	⺮冂一口
桶	木龴用
捅	扌龴用
瞳	目立里
桐	木冂一口
佟	亻夂丶丶
彤	丹丿丿丿
恸	忄二厶力
潼	氵立里
嗵	口龴用辶
僮	亻立里
酮	酉冂一口
仝	人工
茼	艹冂一口
曈	日立里
砼	石人工
烔	火冂一口
橦	木立里
哃	口冂一口
穜	禾立里
鲖	鱼冂一口
㛚	女龴用
峂	山夂丶丶
𦒍	立里习习
𫍣	讠冂一口
头	丶丶大
投	扌几又
偷	亻人一月刂
透	辶禾乃
骰	骨几又
突	宀八犬
图	囗夂丶丶
土	十一
徒	彳土丨一人
吐	口土
途	辶人余下
涂	氵人余下
屠	尸耂日
兔	⺈丨乛一丿乛丶
秃	禾几
凸	丨一丨乛一
荼	艹人余下
菟	艹⺈丨乛一丿乛丶
钍	钅土
堍	土⺈丨乛一丿乛丶
酴	酉人余下
稌	禾人余下
腯	月丿丿十目
葖	艹宀八犬
梌	木人余下
㻬	王雨亏
𬳿	马人余下
团	囗才
湍	氵山而
抟	扌专
彖	乛乛豕
疃	田立里
猯	犭山而
煓	火山而
推	扌亻亠龶
退	辶艮
腿	月艮辶
颓	禾几一丿冂人
褪	衤艮辶
蜕	虫丷口儿
煺	火艮辶
魋	鬼亻亠龶
𬯎	阝中一冂人
吞	天口
屯	一乛丨乛
臀	尸艹一八几又月
豚	月豕
饨	饣屯
暾	日亠口子攵
鲀	鱼屯
坉	土屯
忳	忄屯
焞	火亠口子
脱	月丷口儿
托	扌丿七
拖	扌丿一也
妥	丿⺍女
陀	阝宀匕
驼	马宀匕
唾	口垂
佗	亻宀匕
椭	木阝𠂇月
坨	土宀匕
沱	氵宀匕
砣	石宀匕
鸵	鸟宀匕
跎	⻊宀匕
柁	木宀匕
酡	酉宀匕
橐	一丨乛一丨冖石木
柝	木斥
侂	亻广丿七
鼍	口口田一口电
庹	广廿尺
箨	⺮扌又一一丨
萚	艹扌又一一丨
圫	土丿七
𬶍	鱼宀匕
哇	口土土
瓦	一乛乛丶
娃	女土土
挖	扌宀八乛
袜	衤末
蛙	虫土土
娲	女口内
洼	氵土土
佤	亻瓦
窊	宀八瓜
腽	月日皿
坬	土瓜
畖	田瓜
外	夕卜
歪	不正
崴	山戌女
完	宀二儿
晚	日⺈丨乛一丿乛
玩	王二儿
弯	亠丨丨丿丶弓
碗	石宀夕乛乛
湾	氵亠丨丨丿丶弓
婉	女宀夕乛乛
挽	扌⺈丨乛一丿乛
腕	月宀夕乛乛
宛	宀夕乛乛
顽	二儿一丿冂人
丸	丿乛丶
惋	忄宀夕乛乛
蜿	虫宀夕乛乛
琬	王宀夕乛乛
纨	纟丸
婠	女宀㠯
皖	白宀二儿
绾	纟宀㠯
剜	宀夕乛乛刂
菀	艹宀夕乛乛
豌	一口丷一宀夕乛乛
畹	田宀夕乛乛
烷	火宀二儿
脘	月宀二儿
芄	艹丸
塆	土亠丨丨丿丶弓
椀	木宀夕乛乛
𬇕	氵万
王	一土
望	亡月王
往	彳主
忘	亡心
网	冂乂乂
亡	亠乛
汪	氵王
妄	亡女
旺	日王
枉	木王
惘	忄冂丷一亡
罔	冂丷一亡
魍	鬼冂丷一亡
尢	𠂇乛
辋	车冂丷一亡
尪	尢王
为	丶丿乛丶
位	亻立
微	彳山一几攵
未	一一丨丿ㄟ
围	囗韦
卫	卩一
威	戌女
味	口未
维	纟亻亠龶
危	⺈厂乛乛
委	禾女
伟	亻韦
谓	讠田月
唯	口亻亠龶
慰	尸二小寸心
尾	尸毛
喂	口田一乛丿ㄟ
魏	禾女鬼
薇	艹彳山一几攵
惟	忄亻亠龶
违	辶韦
韦	一一乛丨
畏	田一乛丿ㄟ
伪	亻为
尉	尸二小寸
胃	田月
巍	山禾女鬼
蔚	艹尸二小寸
偎	亻田一乛丿ㄟ
萎	艹禾女
苇	艹韦
炜	火韦
玮	王韦
猥	犭田一乛丿ㄟ
娓	女尸毛
帷	巾亻亠龶
纬	纟韦
渭	氵田月
桅	木⺈厂乛乛
嵬	山鬼
猬	犭田月
隗	阝鬼
葳	艹戌女
痿	疒禾女
闱	门韦
煨	火田一乛丿ㄟ
诿	讠禾女
韪	日一丨一人韦
逶	辶禾女
帏	巾韦
圩	土于
潍	氵纟亻亠龶
溦	氵彳山一几攵
鲔	鱼𠂇月
艉	舟尸毛
隈	阝田一乛丿ㄟ
洧	氵𠂇月
沩	氵为
廆	广鬼
霨	雨尸二小寸
涠	氵囗韦
亹	亠丿丨一一冂一口乛一一冖且
碨	石田一乛丿ㄟ
煟	火田月
琟	王亻亠龶
硙	石山己
薳	艹土口𧘇辶
峗	山⺈厂乛乛
洈	氵⺈厂乛乛
螱	尸二小寸虫
鳂	鱼田一乛丿ㄟ
鳚	鱼尸二小寸
𣲗	氵韦
𫇭	艹为
𬀩	日韦
𬱟	⺈厂乛乛一丿冂人
𬶏	鱼⺈厂乛乛
问	门口
文	亠乂
温	氵日皿
闻	门耳
稳	禾⺈彐心
吻	口勿
纹	纟文
雯	雨文
蚊	虫文
芠	艹文
瘟	疒日皿
紊	文幺小
汶	氵文
玟	王文
刎	勿刂
炆	火文
璺	丿丨一一冂一口乛一一冖玉
阌	门丿⺍冖又
辒	车日皿
榅	木日皿
蕰	艹氵日皿
鳁	鱼日皿
𫘜	马文
翁	八厶习习
嗡	口八厶习习
瓮	八厶瓦
蓊	艹八厶习习
蕹	艹亠乡亻亠龶
滃	氵八厶习习
鹟	八厶习习鸟
𬭩	钅八厶习习
我	丿一丨一乛丿丶
握	扌尸一厶土
窝	宀八口内
卧	臣卜
沃	氵夭
倭	亻禾女
龌	止人凵尸一厶土
蜗	虫口内
渥	氵尸一厶土
斡	十日十人丶丶十
幄	巾尸一厶土
挝	扌寸辶
莴	艹口内
硪	石我
肟	月亏
偓	亻尸一厶土
踒	⻊禾女
物	牛勿
五	一丨乛一
武	一弋止
务	夂力
屋	尸一厶土
舞	丿一一丨丨丨丨一夕一乛丨
吴	口天
午	丿干
误	讠口天
雾	雨夂力
乌	丿乛乛一
悟	忄五口
伍	亻五
呜	口乌
巫	工人人
吾	五口
污	氵亏
捂	扌五口
勿	勹丿丿
兀	一儿
侮	亻丿一母
唔	口五口
梧	木五口
妩	女无
芜	艹无
诬	讠工人人
坞	土乌
毋	乛乛丿一
晤	日五口
蜈	虫口天
邬	乌阝
鹉	一弋止鸟
戊	戈丿
忤	忄午
骛	龴乛丨丿攵马
鹜	龴乛丨丿攵鸟
仵	亻午
婺	龴乛丨丿攵女
钨	钅乌
杌	木兀
焐	火五口
庑	广无
寤	宀爿五口
鋈	氵夭金
痦	疒五口
怃	忄无
牾	牛五口
圬	土亏
浯	氵五口
芴	艹勿
迕	辶午
鼯	臼乛丶丶乛丶丶乛五口
旿	日午
靰	革兀
洿	氵大亏
鹀	工人人鸟
郚	五口阝
屼	山兀
珷	王一弋止
铻	钅五口
峿	山五口
珸	王五口
𣲘	氵无
西	一丨乛丿乛一
喜	士口丷一口
息	自心
细	纟田
希	乂𠂇巾
习	乛冫
吸	口及
戏	又戈
洗	氵⺧儿
惜	忄艹一日
席	广廿巾
袭	龙亠𧘇
悉	丿米心
嘻	口士口丷一口
析	木斤
稀	禾乂𠂇巾
熙	匚丨口丨巳灬
夕	丿乛丶
晰	日木斤
溪	氵丿⺍幺大
兮	八一乛
牺	牛西
膝	月木人氺
媳	女自心
隙	阝小日小
昔	艹一日
锡	钅日勿
嬉	女士口丷一口
熄	火自心
犀	尸氺牛
曦	日⺷丿一丨丿丶一乛乛丿丶
禧	礻士口丷一口
皙	木斤白
玺	⺈小玉
汐	氵夕
蜥	虫木斤
奚	丿⺍幺大
唏	口乂𠂇巾
羲	⺷丿一丨丿丶一乛乛丿丶
淅	氵木斤
徙	彳止丨一人
熹	士口丷一口灬
蟋	虫丿米心
翕	人一口习习
檄	木白方攵
僖	亻士口丷一口
窸	宀八丿米心
铣	钅⺧儿
郗	乂𠂇巾阝
晞	日乂𠂇巾
烯	火乂𠂇巾
屃	尸冂人
浠	氵乂𠂇巾
阋	门臼儿
樨	木尸氺牛
傒	亻丿⺍幺大
醯	酉亠厶丿丨乛皿
隰	阝日幺幺灬
螅	虫自心
爔	火⺷丿一丨丿丶一乛乛丿丶
屣	尸彳止丨一人
硒	石西
釐	未攵厂里
葸	艹田心
咥	口一厶土
豨	豕乂𠂇巾
禊	礻丰刀大
饩	饣气
郤	八人口阝
觋	工人人冂见下
穸	宀八夕
嶲	山亻亠龶丨乛丨乛
舄	臼勹灬
舾	舟西
谿	丿⺍幺大八人口
恓	忄西
蓰	艹彳止丨一人
鼷	臼乛丶丶乛丶丶乛丿⺍幺大
粞	米西
巇	山虍一口丷一戈
憙	士口丷一口心
绤	纟八人口
菥	艹木斤
枲	厶口木
潟	氵臼勹灬
肸	月八十
酅	山亻亠龶冂八口阝
睎	目乂𠂇巾
觿	⺈用山亻亠龶冂八口
嶍	山习习白
暿	日士口丷一口
俙	亻乂𠂇巾
熻	火人一口习习
饻	饣亠𧘇
鳛	鱼习习白
𠅤	亠田心
𫘬	马丿⺍幺大
𬭳	钅士口丷一口
𬶮	鱼士口丷一口
下	一卜
夏	一自夂
侠	亻夹
霞	雨乛一丨一一乛一又
瞎	目宀丰口
狭	犭夹
暇	日乛一丨一一乛一又
峡	山夹
虾	虫下
辖	车宀丰口
匣	匚甲
瑕	王乛一丨一一乛一又
遐	辶乛一丨一一乛一又
黠	黑士口
呷	口甲
狎	犭甲
罅	缶虍乎
硖	石夹
柙	木甲
叚	乛一丨一一乛一又
翈	甲习习
先	⺧儿
现	王冂见下
显	日业
线	纟戋
险	阝人一⺍一
仙	亻山
鲜	鱼羊
限	阝艮
闲	门木
陷	阝⺈臼
县	且厶
献	十冂丷干犬
贤	丨丨又冂人
嫌	女丷一乛一一丨丨丿ㄟ
羡	⺷冫⺈人
弦	弓亠幺
掀	扌斤⺈人
宪	宀⺧儿
咸	戌口
衔	彳钅亍
娴	女门木
涎	氵丿丨一乛廴
馅	饣⺈臼
舷	舟亠幺
腺	月白水
暹	辶日亻亠龶
苋	艹冂见下
冼	冫⺧儿
藓	艹鱼羊
锨	钅斤⺈人
霰	雨艹一月攵
跹	⻊千辶
忺	忄⺈人
痫	疒门木
祆	礻天
岘	山冂见下
酰	酉⺧儿
跣	⻊⺧儿
燹	豕豕火
狝	犭⺈小
蚬	虫冂见下
猃	犭人一⺍一
籼	米山
鹇	门木鸟
筅	⺮⺧儿
莶	艹人一⺍一
氙	气山
挦	扌彐寸
崄	山人一⺍一
缐	纟白水
孅	女人人戈韭
伭	亻亠幺
禒	礻乛乛豕
㬎	日幺幺灬
𪾢	目冂见下
𫍯	讠戌口
𬀪	日冂见下
𬸣	宀一一丨丨一八鸟
想	木目心
向	丿冂口
相	木目
像	亻⺈丨乛一丿乛丿丿丿ㄟ
象	⺈丨乛一丿乛丿丿丿ㄟ
响	口丿冂口
香	禾日
项	工一丿冂人
乡	乛乛丿
享	亠口子
翔	⺶习习
箱	⺮木目
祥	礻羊
详	讠羊
湘	氵木目
厢	厂木目
襄	亠口口一一丨丨一𧘇
镶	钅亠口口一一丨丨一𧘇
橡	木⺈丨乛一丿乛丿丿丿ㄟ
饷	饣丿冂口
骧	马亠口口一一丨丨一𧘇
飨	乡人良
庠	广羊
缃	纟木目
芗	艹乡
鲞	龹鱼
瓖	王亠口口一一丨丨一𧘇
葙	艹木目
珦	王丿冂口
𬙋	纟亠口口一一丨丨一𧘇
小	丨丿丶
笑	⺮夭
消	氵⺌月
晓	日一乛丿兀
萧	艹肃
效	亠八乂攵
销	钅⺌月
肖	⺌月
啸	口肃
孝	耂子
逍	辶⺌月
潇	氵艹肃
削	⺌月刂
嚣	口口一丿冂人口口
霄	雨⺌月
宵	宀⺌月
哮	口耂子
箫	⺮肃
筱	⺮亻丨攵
枭	丿乛丶乛木
硝	石⺌月
骁	马一乛丿兀
淆	氵乂𠂇月
魈	鬼⺌月
绡	纟⺌月
哓	口一乛丿兀
鸮	口一乛鸟
崤	山乂𠂇月
枵	木口一乛
猇	犭虍几
洨	氵亠八乂
翛	亻丨夂习习
虓	九虍几
涍	氵耂子
蟏	虫艹肃
敩	⺍冖子攵
滧	氵亠八乂攵
皛	白白白
𫍲	讠丿丨一乛一一丨又
些	止匕二
血	丿皿
谢	讠身寸
写	冖与
邪	牙阝
协	十办
鞋	革土土
斜	人余下丶丶十
泄	氵世
胁	月办
歇	日勹人乛⺈人
屑	尸⺌月
械	木戈廾
携	扌亻亠龶乃
谐	讠比左匕白
卸	午一丨一卩
挟	扌夹
泻	氵冖与
懈	忄⺈用刀牛
蝎	虫日勹人乛
蟹	⺈用刀牛虫
亵	亠扌丸𧘇
邂	辶⺈用刀牛
偕	亻比左匕白
榭	木身寸
燮	火亠一一口火又
楔	木丰刀大
撷	扌士口一丿冂人
瀣	氵丨一夕又韭
獬	犭⺈用刀牛
勰	力力力田心
廨	广⺈用刀牛
缬	纟士口一丿冂人
躞	⻊火亠一一口火又
绁	纟世
渫	氵世木
薤	艹歹韭
榍	木尸⺌月
揳	扌丰刀大
澥	氵⺈用刀牛
薢	艹⺈用刀牛
叶	口十
㙦	人余下丶丶十土
偰	亻丰刀大
𤫉	王火亠一一口火又
𬹼	止人凵人丿丨
新	立朩斤
心	丶乛丶丶
信	亻亠一一口
欣	斤⺈人
辛	立十
馨	士乛丨一丿几又禾日
薪	艹立朩斤
歆	立日⺈人
昕	日斤
衅	血半
芯	艹心
鑫	金金金
忻	忄斤
锌	钅立十
炘	火斤
囟	丿囗乂
伈	亻心
䜣	讠斤
𫷷	广钅⺈人
性	忄生
星	日生
形	开丿丿丿
兴	⺍一八
醒	酉日生
幸	土丷干
型	开刂土
姓	女生
刑	开刂
腥	月日生
杏	木口
猩	犭日生
惺	忄日生
邢	开阝
悻	忄土丷干
荥	艹冖水
擤	扌自田一丿丨
陉	阝乛丶工
荇	艹彳亍
饧	饣乛丿丿
骍	马立十
硎	石开刂
钘	钅开
瑆	王日生
婞	女土丷干
铏	钅开刂
煋	火日生
𫰛	女乛丶工
兄	口儿
胸	月勹乂凵
雄	𠂇厶亻亠龶
凶	乂凵
熊	厶月匕匕灬
汹	氵乂凵
匈	勹乂凵
芎	艹弓
讻	讠乂凵
夐	⺈冂人目夂
诇	讠冂口
修	亻丨夂丿丿丿
秀	禾乃
休	亻木
羞	⺶丑
袖	衤由
绣	纟禾乃
嗅	口自犬
朽	木一乛
锈	钅禾乃
咻	口亻木
岫	山由
貅	豸亻木
馐	饣⺶丑
庥	广亻木
脩	亻丨夂月
溴	氵自犬
琇	王禾乃
髹	一丨一二厶丿丿丿亻木
鸺	亻木鸟
珛	王𠂇月
滫	氵亻丨夂月
䗛	虫亻丨夂月
许	讠午
续	纟十乛丶丶大
需	雨而
须	丿丿丿一丿冂人
虚	虍业
徐	彳人余下
绪	纟耂日
序	广龴乛丨
旭	九日
叙	人余下又
吁	口于
蓄	艹亠幺田
絮	女口幺小
婿	女乛丨一人月
恤	忄血
栩	木习习
墟	土虍业
诩	讠习习
煦	日勹口灬
胥	乛丨一人月
酗	酉乂凵
顼	王一丿冂人
勖	冂一一目力
蓿	艹宀亻百
盱	目于
魆	鬼戈乛
洫	氵血
溆	氵人余下又
糈	米乛丨一人月
谞	讠乛丨一人月
媭	丿丿丿一丿冂人女
昫	日勹口
醑	酉乛丨一人月
珝	王习习
旴	日于
湑	氵乛丨一人月
垿	土广龴乛丨
㳚	氵戍
冔	冂一一口于
𦈡	纟雨而
𬣙	讠于
选	辶⺧儿
玄	亠幺
宣	宀一日一
旋	方丿一乛丨一人
轩	车干
悬	且厶心
喧	口宀一日一
璇	王方丿一乛丨一人
眩	目亠幺
炫	火亠幺
萱	艹宀一日一
漩	氵方丿一乛丨一人
绚	纟勹日
暄	日宀一日一
渲	氵宀一日一
煊	火宀一日一
泫	氵亠幺
铉	钅亠幺
瑄	王宀一日一
烜	火一日一
癣	疒鱼羊
禤	礻罒习习
谖	讠丿⺍一𠂇又
儇	亻罒一口𧘇
玹	王亠幺
楦	木宀一日一
碹	石宀一日一
晅	日一日一
衒	彳亠幺亍
翾	罒一口𧘇习习
痃	疒亠幺
昡	日亠幺
咺	口一日一
暶	日方丿一乛丨一人
愃	忄宀一日一
琄	王口月
𫍽	讠罒一口𧘇
𫓶	钅口月
𫠊	马亠幺
学	⺍冖子
雪	雨彐
穴	宀八
薛	艹丿㠯立十
靴	革亻匕
谑	讠虍一乛一
噱	口虍豕
踅	扌斤口丨一人
鳕	鱼雨彐
茓	艹宀八
峃	⺍冖山
寻	彐寸
训	讠川
迅	辶乛十
巡	辶乛乛乛
讯	讠乛十
询	讠勹日
逊	辶子小
循	彳丿丿十目
勋	口冂人力
熏	丿一丨乛丶丿一丨一一灬
旬	勹日
驯	马川
荀	艹勹日
薰	艹丿一丨乛丶丿一丨一一灬
殉	歹勹日
醺	酉丿一丨乛丶丿一丨一一灬
洵	氵勹日
峋	山勹日
巽	巳巳艹一八
珣	王勹日
汛	氵乛十
徇	彳勹日
浔	氵彐寸
埙	土口冂人
恂	忄勹日
蕈	艹西日十
鲟	鱼彐寸
曛	日丿一丨乛丶丿一丨一一灬
獯	犭丿一丨乛丶丿一丨一一灬
噀	口巳巳艹一八
栒	木勹日
𫄸	纟丿一丨乛丶丿一丨一一灬
𬊈	火彐寸
𬍤	王彐寸
𬘓	纟川
𬩽	彐寸阝
呀	口牙
亚	一业
压	厂十一丶
雅	牙亻亠龶
牙	一乛丨丿
丫	丷丨
讶	讠牙
涯	氵厂土土
哑	口亚
崖	山厂土土
娅	女亚
押	扌甲
鸭	甲鸟
鸦	牙鸟
衙	彳五口亍
芽	艹牙
伢	亻牙
琊	王牙阝
桠	木亚
睚	目厂土土
垭	土亚
岈	山牙
迓	辶牙
蚜	虫牙
玡	王牙
揠	扌匚日女
猰	犭丰刀大
氩	气亚
砑	石牙
堐	土厂土土
眼	目艮
言	亠一一口
严	亚丿
烟	火囗大
演	氵宀一由八
验	马人一⺍一
研	石开
燕	廿口丨一一匕灬
颜	产丿丿丿一丿冂人
掩	扌大电
延	廴丿丨一乛
厌	厂犬
艳	丰⺈巴
炎	火火
沿	氵几口
焰	火⺈臼
岩	山石
淹	氵大电
咽	口囗大
宴	宀日女
嫣	女正一乛灬
妍	女开
彦	产丿丿丿
雁	厂亻亻亠龶
阎	门⺈臼
盐	土卜皿
焉	正一乛灬
衍	彳氵亍
檐	木⺈厂八亠一一口
奄	大电
砚	石冂见下
焱	火火火
俨	亻严
晏	日宀女
胭	月囗大
蜒	虫丿丨一乛廴
魇	厂犬鬼
阉	门大电
湮	氵西土
琰	王火火
筵	⺮丿丨一乛廴
偃	亻匚日女
闫	门三
阏	门方人丶丶
恹	忄厂犬
谚	讠产丿丿丿
兖	亠八厶儿
堰	土匚日女
鄢	正一乛灬阝
滟	氵丰⺈巴
赝	厂亻亻亠龶冂人
唁	口亠一一口
鼹	臼乛丶丶乛丶丶乛日宀女
芫	艹二儿
郾	匚日女阝
酽	酉严
餍	厂犬人良
厣	厂犬甲
谳	讠十冂丷干犬
崦	山大电
弇	人一口廾
黡	厂犬黑
罨	罒大电
渰	氵人一口廾
掞	扌火火
嬿	女廿口丨一一匕灬
棪	木火火
扊	户火火
沇	氵厶儿
甗	虍一口冂丷一丨瓦
殷	丿丿彐乛几又
䶮	龙天
墕	土正一乛灬
戭	宀一由八戈
漹	氵正一乛灬
虤	虍几虍几
蝘	虫匚日女
觃	冂见下子
𪩘	山十冂丷干犬
𫄧	纟丿丨一乛廴
𬙂	纟宀一由八
𬸘	匚日女鸟
样	木羊
阳	阝日
杨	木乛丿丿
扬	扌乛丿丿
养	⺶ㄟ丿丨
洋	氵羊
仰	亻丿乛卩
央	丨夬guài
羊	丷一一一丨
痒	疒羊
漾	氵⺷永
氧	气羊
恙	⺷心
佯	亻羊
鸯	央鸟
殃	歹央
怏	忄央
秧	禾央
炀	火乛丿丿
泱	氵央
鞅	革央
徉	彳羊
烊	火羊
疡	疒乛丿丿
旸	日乛丿丿
飏	几乂乛丿丿
羕	⺷永
蛘	虫羊
垟	土羊
玚	王乛丿丿
咉	口央
钖	钅乛丿丿
要	西女
摇	扌丿⺍缶
药	艹纟勺
妖	女夭
腰	月西女
咬	口亠八乂
遥	辶丿⺍缶
耀	⺌兀习习亻亠龶
瑶	王丿⺍缶
姚	女儿冫丿丶
邀	辶白方攵
钥	钅月
夭	丿大
谣	讠丿⺍缶
幺	乛厶
窑	宀八缶
尧	一乛丿兀
吆	口幺
肴	乂𠂇月
约	纟勺
曜	日习习亻亠龶
窈	宀八幺力
杳	木日
舀	丿⺍臼
爻	乂乂
鹞	丿⺍缶鸟
徭	彳丿⺍缶
轺	车刀口
鳐	鱼丿⺍缶
崾	山西女
窅	宀八目
峣	山一乛丿兀
垚	土土土
珧	王儿冫丿丶
靿	革幺力
猺	犭丿⺍缶
媱	女丿⺍缶
㙘	土西女
也	乛丨乛
业	丨丨丶丿一
夜	亠亻丿乛丶ㄟ
爷	八乂卩
野	里龴乛丨
液	氵亠亻丿乛丶ㄟ
耶	耳阝
页	一丿冂人
曳	丨乛一一乛丿
冶	冫厶口
烨	火亻匕十
噎	口士冖一口丷一
腋	月亠亻丿乛丶ㄟ
靥	厂犬面
椰	木耳阝
掖	扌亠亻丿乛丶ㄟ
晔	日亻匕十
邺	业阝
谒	讠日勹人乛
揶	扌耳阝
铘	钅牙阝
倻	亻耳阝
馌	饣土厶皿
一	一
以	乛丶人
已	乛一乛
意	立日心
衣	亠𧘇
亿	亻乛
易	日勿
依	亻亠𧘇
义	丶乂
异	巳廾
疑	匕矢龴乛丨一人
议	讠义
医	匚矢
伊	亻尹
移	禾夕夕
忆	忄乛
艺	艹乛
亦	亠丿丨丿丶
翼	习习田艹一八
遗	辶中一冂人
益	丷一八皿
宜	宀且
椅	木大丁口
仪	亻义
逸	辶⺈丨乛一丿乛丶
姨	女夷
怡	忄厶口
抑	扌丿乛卩
毅	立丿乛丿丿丿丶几又
役	彳几又
译	讠又一一丨
夷	一乛一乛丿ㄟ
溢	氵丷一八皿
咦	口夷
倚	亻大丁口
矣	厶矢
谊	讠宀且
乙	乛
蚁	虫义
奕	亠丿丨丿丶大
漪	氵犭大丁口
疫	疒几又
绎	纟又一一丨
裔	亠𧘇冂八口
揖	扌口耳
颐	匚丨口丨一丿冂人
驿	马又一一丨
弈	亠丿丨丿丶廾
懿	士冖一口丷一冫⺈人心
邑	口巴
熠	火习习白
屹	山乞
沂	氵斤
羿	习习廾
诣	讠匕日
翌	习习立
轶	车失
呓	口艹乛
翊	立习习
蜴	虫日勿
弋	一乛丶
咿	口亻尹
旖	方丿一大丁口
祎	礻韦
臆	月立日心
彝	乛乛一米幺小廾
贻	冂人厶口
噫	口立日心
佚	亻失
迤	辶丿一也
壹	士冖一口丷一
缢	纟丷一八皿
翳	匚矢几又习习
胰	月夷
痍	疒夷
薏	艹立日心
嶷	山匕矢龴乛丨一人
饴	饣厶口
苡	艹乛丶人
悒	忄口巴
猗	犭大丁口
诒	讠厶口
黟	黑夕夕
峄	山又一一丨
镱	钅立日心
怿	忄又一一丨
眙	目厶口
肄	匕矢聿
铱	钅亠𧘇
挹	扌口巴
乂	丿ㄟ
刈	乂刂
癔	疒立日心
镒	钅丷一八皿
埸	土日勿
佾	亻八月
圯	土巳
瘗	疒夹土
燚	火火火火
劓	自田一丿丨刂
殪	歹士冖一口丷一
浥	氵口巴
扆	户亠𧘇
廙	广田艹一八
簃	⺮禾夕夕
嫕	女匚矢心
舣	舟义
杙	木弋
钇	钅乛
鹢	丷一八皿鸟
宧	宀匚丨口丨
洢	氵亻尹
酏	酉也
繄	匚矢几又幺小
裛	亠口巴𧘇
椸	木方丿一也
踦	⻊大丁口
扅	户夕夕
佁	亻厶口
勚	世冂人力
匜	匚也
鹝	一口冂丷一丨鸟
㑊	亻亠丿丨丿丶
枍	木八一乛
潩	氵田艹一八
螠	虫丷一八皿
𫄷	纟立日心
𫖮	山己一丿冂人
𬟁	艹一口冂丷一丨鸟
𬬩	钅弋
𬺈	止人凵大丁口
因	囗大
音	立日
引	弓丨
隐	阝⺈彐心
银	钅艮
阴	阝月
印	丿乛一卩
吟	口人丶乛
饮	饣⺈人
淫	氵丿⺍壬
姻	女囗大
尹	乛一一丿
茵	艹囗大
瘾	疒阝⺈彐心
胤	丿幺月乛
荫	艹阝月
寅	宀一由八
垠	土艮
氤	气囗大
蚓	虫弓丨
喑	口立日
洇	氵囗大
龈	止人凵艮
鄞	廿丨乛一一一丨一阝
夤	夕宀一由八
窨	宀八立日
霪	雨氵丿⺍壬
狺	犭亠一一口
愔	忄立日
堙	土西土
訚	门亠一一口
吲	口弓丨
铟	钅囗大
嚚	口口臣口口
禋	礻西土
骃	马囗大
慭	来犬心
硍	石艮
珢	王艮
茚	艹丿乛一卩
蟫	虫西日十
龂	止人凵斤
崟	山金
溵	氵丿丿彐乛几又
歅	西土⺈人
䲟	鱼丿乛一卩
𬘡	纟囗大
𬤇	讠西土
𬮱	门西土
应	广⺍一
影	日亠口小丿丿丿
英	艹央
营	艹冖口口
迎	辶丿乛卩
硬	石更
鹰	广亻亻亠龶鸟
赢	亡口月冂人凡
映	日央
莹	艹冖玉
盈	乃又皿
婴	冂人冂人女
樱	木冂人冂人女
颖	匕禾一丿冂人
莺	艹冖鸟
蝇	虫口电
嬴	亡口月女凡
萤	艹冖虫
荧	艹冖火
萦	艹冖幺小
瑛	王艹央
缨	纟冂人冂人女
瀛	氵亡口月女凡
嘤	口冂人冂人女
膺	广亻亻亠龶月
滢	氵艹冖玉
鹦	冂人冂人女鸟
罂	冂人冂人缶
璎	王冂人冂人女
郢	口王阝
颍	匕水一丿冂人
茔	艹冖土
楹	木乃又皿
撄	扌冂人冂人女
潆	氵艹冖幺小
媵	月龹女
瘿	疒冂人冂人女
锳	钅艹央
蓥	艹冖金
溁	氵艹冖木
媖	女艹央
䓨	艹冖缶
用	冂一一丨
永	丶乛乛丿ㄟ
拥	扌用
勇	龴用力
佣	亻用
庸	广乛一一丨乛一一丨
泳	氵永
雍	亠乡亻亠龶
咏	口永
甬	龴用
慵	忄广乛一一丨乛一一丨
俑	亻龴用
恿	龴用心
臃	月亠乡亻亠龶
蛹	虫龴用
邕	乛乛乛口巴
踊	⻊龴用
墉	土广乛一一丨乛一一丨
镛	钅广乛一一丨乛一一丨
颙	禺一丿冂人
痈	疒用
壅	亠乡亻亠龶土
饔	亠乡亻亠龶人良
鳙	鱼广乛一一丨乛一一丨
澭	氵亠乡亻亠龶
鄘	广乛一一丨乛一一丨阝
埇	土龴用
栐	木永
喁	口禺
㶲	火用
鲬	鱼龴用
有	𠂇月
又	乛ㄟ
由	丨乛一丨一
友	𠂇又
游	氵方丿一子
右	𠂇口
优	亻尤
犹	犭尤
幽	山幺幺
油	氵由
尤	尢丶
忧	忄尤
悠	亻丨攵心
诱	讠禾乃
幼	幺力
佑	亻𠂇口
邮	由阝
黝	黑幺力
呦	口幺力
攸	亻丨攵
鱿	鱼尤
酉	西一
繇	丿⺍缶丿幺小
柚	木由
祐	礻𠂇口
铀	钅由
猷	丷酉犬
釉	丿米由
莠	艹禾乃
囿	囗𠂇月
鼬	臼乛丶丶乛丶丶乛由
宥	宀𠂇月
莜	艹亻丨攵
疣	疒尤
侑	亻𠂇月
牖	片户甫
蝣	虫方丿一子
蚴	虫幺力
羑	⺷久
蚰	虫由
莸	艹犭尤
卣	丨一囗乛一
麀	广乛丨丨一比左匕匕
耰	耒一丿丨乛一一冖心夂
浟	氵亻丨攵
槱	木酉灬
铕	钅𠂇月
鲉	鱼由
𬨎	车丷酉
于	一一丨
与	一乛一
语	讠五口
雨	一丨乛丨丶丶丶丶
玉	王丶
余	人余下
遇	辶禺
欲	八人口⺈人
羽	习习
宇	宀于
鱼	⺈田一
预	龴乛丨一丿冂人
育	亠厶月
御	彳午一丨一卩
郁	𠂇月阝
豫	龴乛丨⺈丨乛一丿乛丿丿丿ㄟ
域	土戈口一
狱	犭讠犬
予	龴乛丨
愈	人一月刂心
浴	氵八人口
誉	⺍一八亠一一口
愉	忄人一月刂
愚	禺心
於	方人丶丶
裕	衤八人口
娱	女口天
瑜	王人一月刂
喻	口人一月刂
寓	宀禺
渔	氵鱼
虞	虍口天
俞	人一月刂
禹	丿丨乛一丨乛丨一丶
煜	火日立
舆	丿丨一一车乛一一一八
谕	讠人一月刂
逾	辶人一月刂
榆	木人一月刂
屿	山与
钰	钅玉
驭	马又
渝	氵人一月刂
迂	辶于
淤	氵方人丶丶
毓	丿一母亠厶丿丨乛
瑀	王禹
妤	女龴乛丨
昱	日立
隅	阝禺
禺	丨乛一一丨乛丨一丶
芋	艹于
聿	乛一一一一丨
臾	丿丨一乛一一丿ㄟ
揄	扌人一月刂
峪	山八人口
觎	人一月刂冂见下
妪	女匚乂
谀	讠臾
腴	月臾
盂	于皿
彧	一口一乛丿丿丿丶
庾	广臾
瘀	疒方人丶丶
燏	火龴乛丨丿冂八口
棫	木戈口一
蜮	虫戈口一
圄	囗五口
竽	⺮于
欤	与⺈人
萸	艹臾
鹬	龴乛丨丿冂八口鸟
鬻	弓米弓一口冂丷一丨
龉	止人凵五口
窳	宀八瓜瓜
圉	囗土丷干
纡	纟于
狳	犭人余下
俣	亻口天
燠	火丿冂米大
瘐	疒臾
伛	亻匚乂
饫	饣夭
淯	氵亠厶月
阈	门戈口一
蝓	虫人一月刂
舁	臼廾
遹	辶龴乛丨丿冂八口
雩	雨亏
鹆	八人口鸟
窬	宀八人一月刂
熨	尸二小寸火
玙	王与
嵛	山人一月刂
堉	土亠厶月
褕	衤人一月刂
矞	龴乛丨丿冂八口
畬	人余下田
嵎	山禺
蓣	艹龴乛丨一丿冂人
髃	骨禺
滪	氵龴乛丨一丿冂人
潏	氵龴乛丨丿冂八口
悆	人余下心
敔	五口攵
邘	于阝
鄅	禹阝
艅	舟人余下
㺄	犭人一月刂
原	厂白小
远	辶二儿
员	口冂人
元	二儿
院	阝宀二儿
愿	厂白小心
园	囗二儿
源	氵厂白小
圆	囗口冂人
缘	纟乛乛豕
怨	夕乛乛心
援	扌丿⺍一𠂇又
袁	土口𧘇
辕	车土口𧘇
渊	氵丿米丨
冤	冖⺈丨乛一丿乛丶
媛	女丿⺍一𠂇又
苑	艹夕乛乛
猿	犭土口𧘇
鸳	夕乛乛鸟
垣	土一日一
鸢	弋鸟
沅	氵二儿
爰	丿⺍一𠂇又
瑗	王丿⺍一𠂇又
塬	土厂白小
鼋	二儿口电
掾	扌乛乛豕
垸	土宀二儿
螈	虫厂白小
橼	木纟乛乛豕
蜎	虫口月
嫄	女厂白小
箢	⺮宀夕乛乛
湲	氵丿⺍一𠂇又
眢	夕乛乛目
涴	氵宀夕乛乛
妧	女二儿
羱	⺶厂白小
𫘪	马厂白小
越	土丨一人戈乛
月	冂一一
跃	⻊夭
岳	丘山
悦	忄丷口儿
曰	囗一
阅	门丷口儿
粤	丿囗米一乛
玥	王月
钺	钅戈乛
樾	木土丨一人戈乛
刖	月刂
彟	彐寸艹亻亠龶又
瀹	氵人一口口口冂艹
龠	人一口口口冂艹
爚	火人一口口口冂艹
籥	⺮人一口口口冂艹
𫐄	车兀
𬸚	犭讠犬鸟
云	二厶
运	辶二厶
晕	日冖车
允	厶儿
韵	立日勹冫
芸	艹二厶
孕	乃子
蕴	艹纟日皿
匀	勹冫
陨	阝口冂人
酝	酉二厶
愠	忄日皿
氲	气日皿
耘	耒二厶
昀	日勹冫
纭	纟二厶
殒	歹口冂人
韫	韦日皿
郓	冖车阝
赟	文一弋止冂人
恽	忄冖车
鋆	土勹冫金
郧	口冂人阝
狁	犭厶儿
沄	氵二厶
妘	女二厶
缊	纟日皿
煴	火日皿
筼	⺮口冂人
涢	氵口冂人
馧	禾日日皿
𫖳	尹口一丿冂人
咋	口乍
砸	石匚巾
杂	九朩
咂	口匚巾
匝	匚巾
扎	扌乛
臜	月⺧儿⺧儿冂人
拶	扌乛乛乛夕
在	𠂇丨土
再	一冉
载	十戈车
灾	宀火
宰	宀立十
栽	十戈木
哉	十戈口
仔	亻子
崽	山田心
甾	乛乛乛田
咱	口自
赞	⺧儿⺧儿冂人
暂	车斤日
簪	⺮一乛丿乛一乛丿乛日
瓒	王⺧儿⺧儿冂人
錾	车斤金
糌	米夂卜日
趱	土丨一人⺧儿⺧儿冂人
昝	夂卜日
酂	⺧儿⺧儿冂人阝
寁	宀一乛一一丨一人
脏	月广土
葬	艹歹匕廾
赃	冂人广土
臧	戊乛一丿臣
奘	爿士大
牂	爿羊
驵	马且
早	日十
造	辶⺧口
遭	辶一丨乛一丨丨一日
糟	米一丨乛一丨丨一日
澡	氵口口口木
躁	⻊口口口木
燥	火口口口木
凿	业丷一十凵
噪	口口口口木
灶	火土
枣	一丨乛丨丿ㄟ丶丶
皂	白七
藻	艹氵口口口木
蚤	叉虫
唣	口白七
璪	王口口口木
慥	忄⺧口辶
簉	⺮⺧口辶
𥖨	石口口口木
则	冂人刂
责	龶冂人
择	扌又一一丨
泽	氵又一一丨
啧	口龶冂人
仄	厂人
笮	⺮乍
帻	巾龶冂人
赜	匚丨口丨龶冂人
昃	日厂人
舴	舟乍
箦	⺮龶冂人
迮	辶乍
贼	冂人戈𠂇
鲗	鱼冂人刂
怎	乍心
谮	讠一乛丿乛一乛丿乛日
增	土丷囗⺌日
赠	冂人丷囗⺌日
憎	忄丷囗⺌日
锃	钅口王
缯	纟丷囗⺌日
甑	丷囗⺌日瓦
罾	罒丷囗⺌日
矰	矢丷囗⺌日
鄫	丷囗⺌日阝
综	纟宀二小
䎖	丷囗⺌日习习
炸	火乍
眨	目乏
诈	讠乍
乍	丿一丨一一
渣	氵木日一
札	木乛
闸	门甲
榨	木宀八乍
吒	口丿七
咤	口宀丿七
蚱	虫乍
铡	钅冂人刂
楂	木木日一
鲊	鱼乍
揸	扌木日一
砟	石乍
哳	口扌斤
奓	大夕夕
拃	扌乍
挓	扌宀丿七
痄	疒乍
劄	⺮人一口刂
霅	雨亠一一口
柞	木乍
䃎	石大夕夕
溠	氵⺶工
鲝	⺶鱼
齇	自田一丿丨虍且
寨	宀一一丨丨一八朩
宅	宀丿七
摘	扌亠丷冂十口
债	亻龶冂人
窄	宀八乍
斋	文而
瘵	疒丿乛丶丶二小
豸	丿丶丶丿乛丿丿
战	丨一口戈
站	立丨一口
展	尸艹一乛丿ㄟ
占	丨一口
斩	车斤
沾	氵丨一口
蘸	艹酉亻亠龶灬
绽	纟宀一丨一人
栈	木戋
盏	戋皿
詹	⺈厂八亠一一口
湛	氵其上八乛
崭	山车斤
瞻	目⺈厂八亠一一口
辗	车尸艹一乛丿ㄟ
毡	毛丨一口
旃	方丿一丹
谵	讠⺈厂八亠一一口
搌	扌尸艹一乛丿ㄟ
飐	几乂丨一口
鹯	亠囗口日一鸟
偡	亻其上八乛
栴	木丿一丹
鳣	鱼亠囗口日一
𫗴	饣亠囗口日一
张	弓长
章	立日十
掌	⺌冖口手
丈	一丿ㄟ
帐	巾长
仗	亻丈
障	阝立日十
涨	氵弓长
杖	木丈
账	冂人长
璋	王立日十
胀	月长
彰	立日十丿丿丿
蟑	虫立日十
瘴	疒立日十
樟	木立日十
漳	氵立日十
獐	犭立日十
嶂	山立日十
幛	巾立日十
鄣	立日十阝
嫜	女立日十
暲	日立日十
仉	亻几
找	扌戈
照	日刀口灬
招	扌刀口
赵	土丨一人乂
罩	罒丨一日十
着	⺶目
爪	丿丿丨ㄟ
昭	日刀口
兆	儿冫丿丶
诏	讠刀口
沼	氵刀口
肇	户攵聿
钊	钅刂
棹	木丨一日十
笊	⺮爪
曌	日月宀八工
啁	口冂土口
旐	方丿一儿冫丿丶
𬬿	钅刀口
𬶐	鱼儿冫丿丶
这	辶文
者	耂日
哲	扌斤口
遮	辶广廿灬
浙	氵扌斤
辙	车亠厶月攵
辄	车耳乛
褶	衤习习白
蛰	扌丸虫
蔗	艹广廿灬
蜇	扌斤虫
鹧	广廿灬鸟
喆	士口士口
谪	讠亠丷冂十口
赭	土丿丨丿丶耂日
柘	木石
磔	石夕一乛丨木
锗	钅耂日
啫	口耂日
晢	扌斤日
詟	龙亠一一口
䗪	广廿灬虫
真	十具上八
阵	阝车
震	雨厂二乛丿ㄟ
镇	钅十具上八
珍	王人丿丿丿
针	钅十
振	扌厂二乛丿ㄟ
朕	月丷天
侦	亻丨一冂人
贞	丨一冂人
枕	木丶乛丿乛
诊	讠人丿丿丿
甄	西土瓦
帧	巾丨一冂人
斟	其上八乛丶丶十
祯	礻丨一冂人
臻	一厶土寿上ㄟ禾
桢	木丨一冂人
箴	⺮戌口
缜	纟十具上八
圳	土川
榛	木寿上ㄟ禾
赈	冂人厂二乛丿ㄟ
蓁	艹寿上ㄟ禾
禛	礻十具上八
疹	疒人丿丿丿
砧	石丨一口
鸩	丶乛丿乛鸟
轸	车人丿丿丿
稹	禾十具上八
浈	氵丨一冂人
瑧	王寿上ㄟ禾
畛	田人丿丿丿
胗	月人丿丿丿
鬒	一丨一二厶丿丿丿十具上八
袗	衤人丿丿丿
葴	艹戌口
揕	扌其上八乛
昣	日人丿丿丿
纼	纟弓丨
正	一止
整	束攵正
政	正攵
争	⺈乛一一丨
证	讠正
征	彳正
郑	丷天阝
睁	目⺈乛一一丨
挣	扌⺈乛一一丨
怔	忄正
症	疒正
蒸	艹了乛丿ㄟ一灬
铮	钅⺈乛一一丨
筝	⺮⺈乛一一丨
狰	犭⺈乛一一丨
拯	扌了乛丿ㄟ一
峥	山⺈乛一一丨
钲	钅正
诤	讠⺈乛一一丨
烝	了乛丿ㄟ一灬
只	口八
知	矢口
直	十具上
至	一厶土
之	丶乛ㄟ
指	扌匕日
值	亻十具上
制	丿一一丨乛丨刂
支	十又
志	士心
止	丨一丨一
治	氵厶口
质	丿丿十冂人
置	罒十具上
致	一厶土攵
职	耳口八
智	矢口日
纸	纟氏
织	纟口八
执	扌丸
枝	木十又
植	木十具上
旨	匕日
芝	艹之
吱	口十又
肢	月十又
侄	亻一厶土
脂	月匕日
址	土止
汁	氵十
滞	氵带上冖巾
稚	禾亻亠龶
掷	扌丷天阝
秩	禾失
窒	宀八一厶土
芷	艹止
挚	扌丸手
蜘	虫矢口
帜	巾口八
炙	丿乛丶丶火
趾	⻊止
咫	尺口八
痣	疒士心
徵	彳山一王攵
雉	矢亻亠龶
祗	礻氐
栀	木丿丿一乛乛
痔	疒土寸
栉	木艹卩
祉	礻止
桎	木一厶土
蛭	虫一厶土
鸷	扌丸鸟
郅	一厶土阝
踯	⻊丷天阝
贽	扌丸冂人
陟	阝止丨丿丿
骘	阝止丨丿丿马
彘	乛乛一矢比左匕
跖	⻊石
轾	车一厶土
摭	扌广廿灬
枳	木口八
酯	酉匕日
帙	巾失
禔	礻日一丨一人
卮	丿丿一乛乛
沚	氵止
胝	月氐
觯	⺈用丷丨乛一一一丨
絷	扌丸幺小
埴	土十具上
轵	车口八
黹	业丶丿丨乛丨丿丶
踬	⻊丿丿十冂人
忮	忄十又
晊	日一厶土
畤	田土寸
滍	氵乛丨丨一虫
稙	禾十具上
扺	扌氏
铚	钅一厶土
锧	钅丿丿十冂人
疐	十冖田乛丨一人
跱	⻊土寸
庤	广土寸
泜	氵氐
梽	木士心
榰	木耂匕日
𦭜	艹口八
𬃊	木丿丿十冂人
中	丨乛一丨
终	纟夂丶丶
众	人人人
钟	钅中
忠	中心
仲	亻中
衷	亠中𧘇
肿	月中
冢	冖一丿乛丿丿丶丿ㄟ
踵	⻊重
盅	中皿
锺	钅重
舯	舟中
螽	夂丶丶虫虫
柊	木夂丶丶
茽	艹亻中
周	冂土口
州	丶丿丶丨丶丨
皱	⺈彐乛丿丨又
洲	氵州
咒	口口几
宙	宀由
舟	丿丿乛丶一丶
骤	马耳又亻丿丿丿ㄟ
粥	弓米弓
肘	月寸
轴	车由
昼	尺日一
帚	彐冖巾
胄	由月
纣	纟寸
绉	纟⺈彐
诌	讠⺈彐
妯	女由
碡	石龶母
籀	⺮扌丿乛丶刀田
酎	酉寸
辀	车舟
赒	冂人冂土口
鸼	舟鸟
荮	艹纟寸
婤	女冂土口
㑇	亻⺈彐
㤘	忄⺈彐
主	丶王
住	亻主
注	氵主
助	且力
著	艹耂日
朱	丿未
珠	王朱
诸	讠耂日
逐	辶豕
竹	丿一丨丿一丨
猪	犭耂日
祝	礻口儿
筑	⺮工凡
柱	木主
驻	马主
嘱	口尸禹
烛	火虫
煮	耂日灬
蛛	虫朱
株	木朱
铸	钅寿上寸
诛	讠朱
竺	⺮二
瞩	目尸禹
伫	亻宀一
拄	扌主
侏	亻朱
贮	冂人宀一
茱	艹朱
洙	氵朱
蛀	虫主
渚	氵耂日
箸	⺮耂日
炷	火主
铢	钅朱
躅	⻊罒勹虫
苎	艹宀一
杼	木龴乛丨
翥	耂日习习
槠	木讠耂日
麈	广乛丨丨一比左匕主
潴	氵犭耂日
舳	舟由
邾	朱阝
纻	纟宀一
橥	犭耂日木
砫	石主
柷	木口儿
疰	疒主
蠋	虫罒勹虫
瘃	疒一丿乛丿丿丶丿ㄟ
𬣞	讠宀一
抓	扌爪
髽	一丨一二厶丿丿丿人人土
拽	扌曳
转	车专
专	一一乛丶
赚	冂人丷一乛一一丨丨丿ㄟ
砖	石专
撰	扌巳巳艹一八
篆	⺮乛乛豕
馔	饣巳巳艹一八
颛	山而一丿冂人
啭	口车专
僎	亻巳巳艹一八
瑑	王乛乛豕
䏝	月专
装	冫丨士亠𧘇
状	冫丨犬
庄	广土
撞	扌立里
壮	冫丨士
妆	冫丨女
桩	木广土
追	辶丿㠯
坠	阝人土
缀	纟又又又又
锥	钅亻亠龶
惴	忄山而
赘	龶乛丿攵冂人
椎	木亻亠龶
骓	马亻亠龶
缒	纟丿㠯辶
隹	亻亠龶
准	冫亻亠龶
谆	讠亠口子
肫	月屯
窀	宀八屯
衠	彳十具上八亍
𬘯	纟亠口子
桌	丨一日木
卓	丨一日十
捉	扌口丨一人
琢	王一丿乛丿丿丶丿ㄟ
灼	火勺
拙	扌出
浊	氵虫
镯	钅罒勹虫
酌	酉勺
啄	口一丿乛丿丿丶丿ㄟ
茁	艹出
涿	氵一丿乛丿丿丶丿ㄟ
擢	扌习习亻亠龶
斫	石斤
濯	氵习习亻亠龶
倬	亻丨一日十
浞	氵口丨一人
诼	讠一丿乛丿丿丶丿ㄟ
棁	木丷口儿
禚	礻⺷灬
椓	木一丿乛丿丿丶丿ㄟ
晫	日丨一日十
叕	又又又又
汋	氵勺
䓬	艹丨一日十
䦃	钅艹耂日
𬸦	方丿一矢鸟
子	乛丨一
自	丿目
字	宀子
资	冫⺈人冂人
紫	止匕幺小
姿	冫⺈人女
滋	氵丷一幺幺
姊	女丿乛丨丿
咨	冫⺈人口
梓	木立十
孜	子攵
渍	氵龶冂人
籽	米子
恣	冫⺈人心
龇	止人凵止匕
辎	车乛乛乛田
淄	氵乛乛乛田
眦	目止匕
滓	氵宀立十
嗞	口丷一幺幺
髭	一丨一二厶丿丿丿止匕
孳	丷一幺幺子
缁	纟乛乛乛田
笫	⺮丿乛丨丿
锱	钅乛乛乛田
秭	禾丿乛丨丿
赀	止匕冂人
訾	止匕亠一一口
觜	止匕⺈用
嵫	山丷一幺幺
趑	土丨一人冫⺈人
孖	子子
粢	冫⺈人米
鲻	鱼乛乛乛田
镃	钅丷一幺幺
耔	耒子
鼒	才目乛一丿丨一丨乛
虸	虫子
鄑	亚日阝
总	丷口心
宗	宀二小
纵	纟人人
踪	⻊宀二小
棕	木宀二小
鬃	一丨一二厶丿丿丿宀二小
粽	米宀二小
偬	亻匆心
倧	亻宀二小
鬷	一口冂丷一丨乂凵八夂
腙	月宀二小
疭	疒人人
走	土丨一人
奏	寿上ㄟ天
揍	扌寿上ㄟ天
邹	⺈彐阝
诹	讠耳又
驺	马⺈彐
陬	阝耳又
鄹	耳又亻丿丿丿ㄟ阝
鲰	鱼耳又
组	纟且
足	口丨一人
族	方丿一矢
祖	礻且
阻	阝且
租	禾且
诅	讠且
俎	人人且
镞	钅方丿一矢
菹	艹氵且
崒	山亠人人十
珇	王且
钻	钅丨一口
攥	扌⺮目大幺小
纂	⺮目大幺小
缵	纟⺧儿⺧儿冂人
躜	⻊⺧儿⺧儿冂人
最	日耳又
嘴	口止匕⺈用
罪	罒非
醉	酉亠人人十
蕞	艹日耳又
槜	木亻亠龶乃
尊	丷酉寸
遵	辶丷酉寸
樽	木丷酉寸
鳟	鱼丷酉寸
撙	扌丷酉寸
噂	口丷酉寸
僔	亻丷酉寸
嶟	山丷酉寸
𨱔	钅丷酉寸
做	亻十口攵
作	亻乍
坐	人人土
左	𠂇工
座	广人人土
昨	日乍
佐	亻𠂇工
祚	礻乍
嘬	口日耳又
酢	酉乍
怍	忄乍
胙	月乍
唑	口人人土
捽	扌亠人人十
阼	阝乍
岞	山乍
栓	木人王
拴	扌人王
蟀	虫亠幺冫丿丶十
卍	乛乛
濛	氵艹冖二丿乛丿丿丿ㄟ
衰	亠丨乛一一𧘇
艹	一一丨
觍	丨乛一丨丨一八冂见下
珮	王几一巾
屮	乛丨丨
芔	乛丨丨乛丨丿乛丨丨